الجماال	الجمال
ومساواة	مساواة
السرعه	السرعة
مُكتئب	مكتئب
التجربة…	التجربة
الككل	الكل
أن،	أن
وهوه	وهو
هذآ	هذا
ونجاح	نجاح
وقيادة	قيادة
نجاحه	نجاح
مجموعات	مجموعة
الاصفر	الأصفر
محافظة	مدينة
السلةكرة	كرة
لديہ	لديه
منسابا	كسا
نقطه	نقطة
شاقّ	شاق
العاب	لعبة
مره…	مرة
أنآقة	أناقة
خطااب	خطاب
نفانيف	فستان
منذُ	مذ
مُخجل	مخجل
العاالم	العالم
صحي…	صحيح
الضروره	الضرورة
السوؤال	السؤال
سمحوا	سمح
المآضي	الماضي
صخراء	صحراء
اغاني	أغنية
عصراً	ظهرا
أحوال_الطقس	الطقس
بسبة	بسبب
‏بين	بين
بوضع	وضع
سبب…	سبب
الحقّ	الحق
‏كان	كان
ﺎلعين	العين
مطالبةً	مطالبة
حزين،	حزين
ظلِّ	ظلّ
فكانت	وكانت
أنىٰ	أنّى
الحليب	حليب
عِدة	عدة
باتَ	بات
تبددل	تبدّل
بطئية	بطيئة
‏​البعض	البعض
أدَّى	أدى
صــاعق	صاعق
سؤالك	السؤال
مثلّث	مثلث
سريع🌹	سريع
غدًا	غدا
يريد	تريد
وتختلف	تختلف
خطيــر	خطير
معطَف	معطف
أسوداطار	إطار
بعقد	عقد
لذييذ	لذيذ
يوسف||	وسيم
أناقہ	أناقة
⁰إن	إن
ركوبي	ركوب
ايضاً	أيضا
الاخضر	الأزرق
لحظـة	لحظة
اما	أما
عداا	عدا
جنااح	جناح
إيّاك	إياك
إنضمام	انضمام
متوسط،	متوسط
فهـلا	هلّا
وحيداً	وحيد
؛يمكن	يمكن
بكِ…	بكما
إيآها	إياها
جميل✨	جميل
بياكد	واكد
الارض	الأرض
الموضوع☺	الموضوع
ثﻻثة	ثلاثة
السكر؟	السكر
سير،	سير
لاتحوي	تحتوي
هؤلاءِ	هؤلاء
بهائمي	شائن
تُلقي	تلقي
،هلّا	هلّا
‏ثمّة	ثمّة
االصعب	الصعب
ومبهج	مبهج
للات	لات
للك	لك
إجل	أجل
الأربعاء	السبت
أسمراني	أسمر
الماضي…	الماضي
لبن	حليب
واضحح	واضح
لسلسة	سلسلة
يَاأَيّهَا	لَسْتُنَّ
الالى	الألى
لازال	مازال
ملاحقة	مطاردة
أجمّع	أجمع
أسمه	إسم
تمااما	تماما
الشمس	شمس
يتفوق	متفوق
باااب	باب
سسجل	سجل
‏‏لم	لم
كادَ	كاد
عرفوا	عرف
آنا	أنا
رجل،	رجل
والدة	زوجة
القلي…	القليل
لخطة	خطة
اِليك	إليكَ
ثم…	ثم
إبقى	أبقى
ماكانت	كانت
ضحيّة	ضحية
دائرة…	دائرة
وبرتقالي	رمادي
مفتوحة،	مفتوحة
وهما	هما
الجدول؟	الجدول
نوم💔	نوم
عزيزي	عزيزتي
قطرةِ	بقعة
ودهنه	دهن
هيه	هيا
الأخيرتان	اللتين
الموضوعي،	الذاتي
اسود	أسود
ستتضاعف	مضاعفة
خلفّ	خلف
هذأ	هذا
الأبتسامه	الابتسامة
عاجلوكالة	لوكالة
قدييم	قديم
،،اما	اما
مدفيديف	ظريف
بارد،	بارد
تحتااج	تحتاج
درجة…	درجة
بِنَا	بنا
مسئله	مسألة
قوة،	قوة
تعلق	علق
صوٺ	صوت
ماعدا	عدا
راحح	راح
الفصل	الصف
آآآه	آه
الجنوب…	الجنوب
الهوّة	الفجوة
عددد	عدد
مرغوبَ	مرغوب
آخر	آخر
الدوﻻر	الدولار
صَبَبْنَا	هَيْهَاتَ
مُظلم	مظلم
بحالة	حالة
فععل	فعل
”لن	لن
اﻵن	الان
عظِيم	عظيم
وزبيرية	زري
‏انا	أنا
حفرة…	حفرة
نوعع	نوع
لدولة	دولة
الازرق	الأخضر
أطفالنا	الأطفال
لكي	لكيلا
الابطين	الرقبة
تطلبين	تطلب
كره…	كره
،ٰبديع	بديع
حزينَ	حزين
جدًا	جدا
شهرر	شهر
ممتا…	ممتاز
ايآ	أيا
ينشئ	أنشأ
متفوقا	متفوق
ثنين	اثنين
لديكم	لدينا
النهر،	النهر
اللقطة	القفزة
آسم	إسم
ارض	أرض
تححمل	تحمل
عسـى	عسى
الأنيق،	الأنيق
لنا♥	لنا
مرة…	مرة
«إياكم	إياكم
أنتنّ	أنتن
ثانٍ	ثان
كذا؟	كذا
العصوية	الحشرة
‏قد	قد
الحشره	الحشرة
خلآ	خلا
الكتاب	كتاب
مراكز	مركز
مآء	ماء
قادرة…	قادرة
اولائك	أولئك
عﻻمة	علامة
بطآقة	بطاقة
خووف	خوف
الصندوق	صندوق
النآس	الناس
خائِف	خائف
عينَ	عين
سيجلب	جلبت
فقراء	فقير
كان	وكان
لمّس	لمس
الامة	الأمة
؟لئن	لئن
دخول…	دخول
منطقة	مدينة
ستوافق	توافق
زال	مازال
حافّة	حافة
سيحدث	حدث
،أو	أو
بحرمن	بحر
شاملة	شامل
الرجوع	الوصول
،نصف	نصف
كَيفما	كيفما
لديكم	لديه
مآدآم	مادام
حاااد	حاد
،ربما	ربما
ايا	أيا
الدم،،	الدم
الحمار	الكلب
مايزال	مازال
اﻻقل	الأقل
وحيده	وحيد
يعل	جعل
إسرة	عائلة
الفجوه	الفجوة
كلآ	كلا
الجواب…	الجواب
لطيفّ	لطيف
يبدا	بدأ
إذْ	إذ
أمّ	أم
‏​نحن	نحن
الانمائية	الرئيسية
لفرع	فرع
انّ	ان
متعارف	معتاد
ودفع	دفع
ٺلك	تلك
المُقبل	المقبل
مساءء	مساء
مككن	ممكن
وأصبح	أصبح
عقدتُ	عقدت
لبضع	بضع
رُكن	ركن
وبالنتيجة	وبالتالي
فخممم	فخم
وامتزاج	مزيج
ملـح	ملح
مصلحة…	مصلحة
سسمعت	سمعت
مقآبل	مقابل
الحاظر	الحاضر
شبهعليك	شبه
نسخا	نسخة
اشتري	اشترى
وكرر	كرر
ظهرا،	ظهرا
إِنَّ	إِنَّ
المزيلات	المعادن
الارطى	العشب
بمستوى	مستوى
أنَّى	أنّى
،تختلف	تختلف
وزهرة	زهرة
عُلبة	علبة
فمّ	فم
سهُولة	سهولة
الأنيقفي	الأنيق
خُطوة	خطوة
مؤسف	محزن
سيستغرق	استغرق
،اما	اما
مباشـر	مباشر
أراد…	أراد
خطابات	خطاب
قُرب	قرب
حاليًا	حاليا
امراة	فتاة
مشرقه	مشرق
تغير	تغيير
عمِيق	عميق
قوّي	قوي
آلرد	الرد
بميناء	ميناء
آلعكس	العكس
حَبَّذَا	حَبَّذَا
حياة…	حياة
الأم،	الأم
آمام	امام
بحل	حل
رمزٌ	رمز
والأفنان	ذواتا
يعتمد	تعتمد
حصولي	الحصول
كبير،	كبير
لقاءات	لقاء
البنجر	الذرة
خلفَ	خلف
،كانت	كانت
ولون	لون
شااااق	شاق
\/صالح	صالح
وعسى	عسى
السيروم	البخار
جزءا	جزء
المعنى…	المعنى
مآت	مات
،،،هي	هي
ححلم	حلم
خيااالي	خيالي
سابقا	السابق
،و	و
رملٍ	رمل
أناقـة	أناقة
واتجددله	حوالى
جديدة…	جديدة
شجرة	صخرة
العكسسس	العكس
ومنطقة	منطقة
المشهورة	الشهيرة
ضدد	ضد
إلىٰ	إلى
خلال…	خلال
فيالأرض	الأرض
بدااية	بداية
اصغي	استمع
إسم	اسم
هككذا	هكذا
السباق	سباق
بمصنع	مصنع
الأقماح	اللحوم
بأيخ	بايخ
دراسه	دراسة
هَادئ	هادئ
،أو	او
الجبل،	الجبل
آبقى	أبقى
أربگ	أربك
لفّة	لفة
العمل،	العمل
آلكل	الكل
بمكتب	مكتب
والتيار	التيار
لمآ	لما
رحلات	رحلة
،،يجب	يجب
بينقلب	انقلب
بشع	شنيع
مُروع	مروع
،على	على
مُذنب	مذنب
أثنين	اثنين
قُوة	قوة
حاصِل	حاصل
رحلة…	رحلة
وواضح	واضح
الامه	الأمة
رآقب	راقب
مرةً	مرة
تعرفي	تعرف
بِي	بي
نِعمَ	نِعْمَ
جداً	جدا
،ماعدا	عدا
》معطف	معطف
لنا💛	لنا
بأنّ	بان
حيُ	حي
آلحديث	الحديث
درج…	درجة
الورك	الرقبة
🌿زيت	زيت
ﺎلنهر	النهر
العآلم	العالم
جيدة	سيئة
جولة…	جولة
ﺎبيض	أبيض
المسليات	الفاكهة
جلل،	جلل
السلي…	السليم
همآ	هما
حالات	حالة
مككان	مكان
احد♥	احد
تظـهر	تظهر
بماذأ	بماذا
بمأ	بما
ألذين	اللذين
حَياة	حياة
اختيا…	اختيار
أنماط	نمط
باان	بان
‏استمع	استمع
ظمن	ضمن
كانت…	كانت
ابقا	أبقى
حقيقي،	حقيقي
الحشد_الشعبي	الحشد
بأخذ	أخذ
عقيم…	سقيم
الجبهات	الجبهة
الجليد…	الجليد
السولار	الغاز
آصبح	أصبح
كبييير	كبير
حصلنا	حصلت
المعني	المعنى
عده	عدة
​إذا	إذا
أبقىَ	أبقى
سوفَ	سوف
ناادم	نادم
اولئك	أولئك
فاشل	فاسد
ٺحتوي	تحتوي
فخم	فاخر
تُحقق	تحقق
وضييع	وضيع
الكﻻم	الكلام
سمعَ	سمع
ﺎلوقت	الوقت
‏لكي	لكي
ذيّ	ذِي
فطاع	قطاع
الثالثه	الثانية
مؤكد،	مؤكد
لكـ	لك
سههل	سهل
الاخيرة،	الاخيرة
وبذلك	وبالتالي
مديو…	مريض
القائمة	قائمة
بنا،	بنا
بارسال	إرسال
ذاااك	ذاك
مُحبّب	محبب
مُذهل	مذهل
اختباار	اختبار
مزبوط	مضبوط
مَّعَنَا	حَبَّذَا
سلسلة⁩	سلسلة
السوفياتية	الملكية
حفض	حفظ
الكثير”	الكثير
نظيف…	نظيف
كيفمّا	كيفما
واعتقد	اعتقد
غالبًا	غالبا
مسسكين	مسكين
حسـب	حسب
انخفاظ	ارتفاع
آما	أمّا
الوُقوف	الوقوف
،أيا	أيا
غضب،	غضب
قوةة	قوة
الحديثَ	الحديث
لي🌿	لي
ممتاااز	ممتاز
اما	إمّا
ماااات	مات
سرييييع	سريع
‏مسكين	مسكين
الرسالة،	الرسالة
أخت	أخ
رااائع	رائع
حصولهن	الحصول
مگتوبہ	مكتوبة
ثقيلة…	ثقيلة
التجارة	تجارة
وقطاع	قطاع
المعنىٰ	المعنى
موُجع	موجع
البلتاجي،	العشري
واما	اما
اللاتي	اللائي
بطاقت	بطاقة
حربا	حرب
يطلبون	تطلب
الأن	حاليا
الامر	الموضوع
اابيض	أبيض
الرابع	الثاني
سعيدة…	سعيدة
مگان	مكان
خارطة	خريطة
عـام	عام
أحكام	حكم
المثانة	الأنف
أهـل	أهل
‏لما	لما
آلجمال	الجمال
الصنفان	اللذان
مكانٍ	مكان
العالم؟	العالم
الجُلوس	الجلوس
عليه💙	عليه
إليكك	إليكَ
حلمم	حلم
نهايةة	نهاية
مالذي	بماذا
يآئس	يائس
القليّل	القليل
؛لن	لن
منحهم	منح
ماارسلت	أرسلت
ويابرى	بري
وزنكِ	الوزن
الوقحان	اللذان
ومكتب	مكتب
ومشهد	مشهد
بااطل	باطل
تصمي…	تصميم
المعنى،	المعنى
ملوك	ملك
عبور💛	عبور
الخنزير	الكلب
كرري	كرر
انشأ	أنشأ
وفِي	وفي
واثبات	إثبات
،،،بل	بل
“لماذا	لماذا
أنيـق	أنيق
أبيض،	أبيض
طار	يطير
لسحب	سحب
اللعب	لعب
،تذكر	تذكر
أحذية	حذاء
ملعووون	ملعون
و7	و6
تحملُ	تحمل
حارا	حار
بقرب	قرب
مُخجل	محزن
الفضا	الفضاء
اكتر	اكثر
‏أنت	أنت
عاام	عام
كرروا	كرر
وااكد	واوضح
ﺎلرد	الرد
إنَّما	إنّما
الاستقصائية	الصحافة
أعمدة	عمود
أرسال	إرسال
كى	لكي
انخفاظ	منخفض
مطر❤️	مطر
الباستل	الطلاء
بمذكرة	مذكرة
ضذ	ضد
الجدار	جدار
عااامة	عامة
قائلة	وقالت
فية	فيه
تّام	تام
في…	في
تقسيمهم	تقسيم
الخاصة…	الخاصة
ولاجناح	جناح
الكثير…	الكثير
واصبح	أصبح
سلڪ	سلك
حزيـن	حزين
اجمع	جمع
لمحطة	محطة
خير…	خير
آضحى	أضحى
إيحابي	إيجابي
بحجم	حجم
الكلفة	التكلفة
كانَت	كانت
باااايخ	بايخ
ارأد	رغب
كااااملة	كاملة
گوكب	كوكب
مسطلح	مصطلح
آول	اول
إكتشاف	اكتشاف
الربيع،	الربيع
لمسار	مسار
‏‏كل	كل
ارتدائك	ارتداء
أنتشار	انتشار
صغي…	صغير
الطود	الجبل
وفرع	فرع
المال…	المال
نتآج	نتاج
كيفماء	كيفما
لمسها	لمس
تفاحةة	تفاحة
مصنعين	منجم
القادم10	المقبل
عامة؟	عامة
لحل	حل
لكممم	لكم
اتصالات	اتصال
الفرحَ	الفرح
النقدي،	السليم
لَستُ	لَسْتُ
حفرھہ	حفرة
الصعود	الوصول
آلنفس	النفس
الخرافات؟	الضوضاء
أعادة	اعادة
كماآ	كما
خير💜	خير
هذاا	هذا
حلمٍ	حلم
وآن	وان
حآد	حاد
سكّة	سكة
أكتر	أكثر
أياكم	إياكم
فآن	فان
،جلب	جلب
الجبل	جبل
ومجلس	مجلس
مُشكلة	مشكلة
قادر	قادرة
“مجلس	مجلس
وجعل	جعل
واهي	وهي
بانه	انه
ابيض	أبيض
قووى	قوى
فخمممم	فخم
اكياس	كيس
ياجعل	جعل
شــَخْص	لَسْتُ
وتغيير	تغيير
تمثيلهم	تمثيل
قرى	قرية
أستعمال	استخدام
‏​فن	فن
السابق…	السابق
أَيَّامِ	لَيْسَتْ
ثمانون	عشرون
بسرعة،	بسرعة
🔴وكالة	لوكالة
،هي	هي
السؤآل	السؤال
إتاوة	غرامة
إذاأنفق	أنفق
‏إنما	إنّما
أدّى	أدى
الرقبه	الرقبة
بمّا	بما
غاز	الغاز
الصورة😊	القفزة
مُستغرب	معتاد
ولذا	وبالتالي
مايحسو	نحس
تُحوّل	تحوّل
ولحماية	حماية
ونوع	نوع
تفوّق	تفوق
وواسع	واسع
حـبل	حبل
عامة…	عامة
اَي	اي
استراحة_الرياض	استراحة
مسألة…	مسألة
ﺎلفرح	الفرح
وشرير	شرير
يُثقلنيهلّا	هلّا
اراد	أراد
تيين	تين
حينما	عندما
اللكل	الكل
هاادئ	هادئ
خارطه	خريطة
سيده	سيدة
المفهوم	المعنى
آمامك	أمامك
للانف	الأنف
به💙	به
عامود	عمود
لجلب	جلب
نمى	نما
راينبو	تين
الملوثات	الضوضاء
قاموا	قام
قيمته	قيمة
لبحيرة	بحيرة
خاطئ،	خاطئ
لتوفير	توفير
وخلف	خلف
الليل؟	الليل
المنحوووس	منحوس
وجـه	وجه
محبوبه	محبوب
عامم	عام
بآب	باب
قريتي	قرية
دائماا	دائما
‏لم	لم
سميّكك	سميك
ضئِيل	ضئيل
بااارد	بارد
جزءٌ	جزء
،ثمة	ثمّة
أينماا	حيثما
احرق	حرق
عقده…	عقد
خووورافي	خرافي
گتاب	كتاب
يحتوى	تحتوي
حَزين	حزين
ايّ	إي
الجانِب	الجانب
حاصـل	حاصل
إلاّ	إلّا
آسفه	آسف
أنشأنا	أنشأ
إليكم…	إليكم
أنشأوا	أنشأ
كربم	كريم
اجمع	أجمع
غضَب	غضب
مشرعة	مفتوحة
اياك	إياك
بَاب	باب
لارسال	إرسال
آسـف	آسف
بـال	بال
عُبور	عبور
ميتّ	ميت
وتتحدّث	وتحدث
مصحلة	مصلحة
القطار	قطار
فخخم	فخم
للشباب	الشباب
الاجواب	الجواب
اكدت	اكد
18شاهد	شاهد
أيّ	أي
“كرة	كرة
التظر	النظر
الفضاء؟	الفضاء
مزرعه	مزرعة
تهلكُني	تلكما
ألحان	لحن
تجاة	تجاه
_الناس	الناس
سمعت…	سمعت
بمنح	منح
طالب_	طالب
قدمنا	قدم
هاا	ها
ليّنة	لينة
طبيعي…	طبيعي
اين	أين
جُزء	جزء
جنونى	جنوني
بكنّ	بكن
ماسمع	سمع
هذآ	هَذا
وتمر	تمر
حسَّاس	حساس
•مادام	مادام
‏​صور	صور
مشررق	مشرق
بسفينة	سفينة
هياا	هيّا
“لكي	لكيلا
للتربة	التربة
ختر	اختر
واااا	وا
مانرهم	مغناطيس
هِنا	هنا
دوله	دولة
لربما	ربما
بقره	بقرة
مباراه	مباراة
طالبة	طالب
فكوكب	كوكب
القرن…	القرن
شكرآ	شكرا
گرسي	كرسي
أدی	أدى
تفوووق	تفوق
الأطفال…	الأطفال
فحدد	حدد
كاملة،	كاملة
وتجاه	تجاه
باااااارد	بارد
عضوة	عضو
الصندوق	البنك
لتسجيل	تسجيل
اﻻرقام	الأرقام
بالتالي	وبالتالي
ميزات	ميزة
عقيد	نقيب
مسساء	مساء
تقطة	نقطة
الضحك…	الضحك
وثقيلة	ثقيلة
صَديق	صديق
ظَهر	ظهر
لدي	لدينا
هم	هما
يحدد	حدد
ٺطلب	تطلب
قريب”	قريب
استثائي	استثنائي
أنييق	أنيق
السؤل	السؤال
لگن	لكن
اﻷرقام	الأرقام
لرحلة	رحلة
وحسن	حسن
مستوي	مستوى
وكرسي	كرسي
نِصف	نصف
كُرَب	كرب
أضافة	إضافة
بشگل	بشكل
فالصفحة	الصفحة
بعدم	عدم
…ومن	ومن
إشتعلت	اشتعلت
كذه	كذا
كرة	كره
،فوق	فوق
طلبت	تطلب
مُثلث	مثلث
خخير	خير
جندي…	جندي
مروّع	مروع
أيض…	أيضا
بشري؟	بشري
والحشد	الحشد
إنتشار	انتشار
التأريخ	التاريخ
لدية	لديه
ارجوا	الرجاء
المـوت	الموت
حكم	الحكم
الحگم	الحكم
الأكسجين…	الأكسجين
مُبتذل	مبتذل
تتلقي	تلقي
ألاول	الاول
تذكري	تذكر
آنتم	أنتم
،صديق	صديق
رمزا	رمز
اصابع	إصبع
فترةة	فترة
لبطاقة	بطاقة
الحملاوي	العشري
قاربها	قارب
أنتِي	أنتِ
أيد	يد
آكل	أكل
وهي…	وهي
إياها	إياه
الشديد	شديد
عامٍ	عام
سَبب	سبب
وسقط	سقط
لعييين	لعين
لسفينة	سفينة
ذرة	بذرة
اضمن	تضمن
الكاوية	الذهب
؟لماذا	لماذا
الصفحة…	الصفحة
اخذ	أخذ
ذاات	ذات
أُفٍّ	أُفٍّ
بألتاكيد	بالتأكيد
اليك	إليكَ
🍂سبحان	سبحان
ضحيتها	ضحية
اليومغدًا	اليوم
التجمعات	الحركة
⁰إذا	إذا
الخيال	خيالي
بتجربة	تجربة
يضمنوا	تضمن
صفقتي	صفقة
⁰ومن	ومن
أناا	أنا
قليل💔	قليل
نضام	نظام
الحجاز	الجنوب
جنوني…	جنوني
رآئحة	رائحة
اياااام	ايام
عليه”	عليه
مشكلة…	مشكلة
استمعو	استمع
وصفَ	وصف
اعلى	أعلى
الترقوه	الساق
جمميل	جميل
الحيوانات	الحيوان
ايجابي	سلبي
أنيق،	أنيق
الركبة	الساق
التی	التى
أعطىٰ	أعطى
ليّٺ	لَيْتَ
النار🙏	النار
رقيق،	رقيق
طاالب	طالب
الثانية	الاولى
وهاكَ	هاكَ
تااااام	تام
ماجيستير	امتياز
لهآ	لها
كذبةة	كذبة
ماأرسلتها	أرسلت
لي❤	لي
كذلك…	كذلك
أمامك،	أمامك
مفتاح…	مفتاح
بوصول	وصول
دآم	مادام
العدو…	العدو
فقيـر	فقير
هآآدئ	هادئ
انجاز	منجز
،اما	أمّا
‏خلف	خلف
المقعد	مقعد
سياراة	سيارة
🌹الذي	الذى
الكثيرمن	الكثير
دوننك	دوني
عاماً،	عاما
ثمّـة	ثمّة
واصبع	إصبع
نفسه…	نفسه
ذآت	ذات
الصمٺ	الصمت
محتااج	محتاج
مشرق،	مشرق
بداية	نهاية
الصّعب	الصعب
‏هكذا	هكذا
سعييدة	سعيدة
،،أحلا	الألاء
المشتتات	الضوضاء
تمامًا	تماما
خطوط	خط
العربيتان	اللتان
تعميم	توجيه
لاتريد	تريد
منحهن	منح
مضاعفة…	مضاعفة
الإسترليني	الجنيه
الموضوع…	الموضوع
فادارة	واضافت
التعريفة	التكلفة
و٦	و6
مُترف،	مترف
مظلمً	مظلم
سعيدهه	سعيدة
اختبآر	اختبار
،أنا	أنا
مزﻻج	مزلاج
المومياوات	الغابات
👈سبحان	سبحان
اقامة	إقامة
لقمہ	لقمة
مصالح	مصلحة
مركب	قارب
فسُرعان	سرعان
السلوكي	الذاتي
قائمه	قائمة
القسم،	القسم
سسماء	سماء
قلبّ	قلب
دي؟؟	ديك
قطآر	قطار
لهيومن	للامم
وهزيل	هزيل
ثالثا	رابعا
ممنّ	ممن
ظريف؟	ظريف
ببلد	بلد
النّظر	النظر
_عسى	عسى
رفيع…	رفيع
الإجابه	الجواب
تدعوالي	تعجبي
ارتفااع	الارتفاع
،أقبل	أقبل
﴿هاؤم	هاؤم
شمسٌ	شمس
دائر…	دائرة
لحرب	حرب
؛؛تلك	تلكم
حَتَّىٰ	حَتَّى
اﻷساسية	الأساسية
خير،،	خير
لنهائي	نهائي
السليم،	السليم
كيفمَا	كيفما
وخاصة	خاصة
طُول	طول
ﺎلعباره	العبارة
قدمه	قدم
ربماا	ربما
الأب	الأم
الدم…	الدم
ذاء	ذا
بالرقم	الرقم
صخرةً	صخرة
أوقف	وقف
،خلف	خلف
زووجة	زوجة
اسواق	سوق
لشمس	شمس
أجمعَ	أجمع
وابقى	أبقى
كرسى	كرسي
مفاجئه	مفاجأة
ثقيل	ثقيلة
گكل	ككل
الَّذين	الذين
آسفه	أسف
وفِ	وفي
آي	أيّ
ماخلاء	خلا
واحد…	واحد
،لمّا	لمّا
نَكَالًا	هَيْهَاتَ
نحنُ	نحن
له🌿	له
فوزهم	فوز
إلى	الى
ماهي	مهيب
هُنا	هنا
وحرق	حرق
مته	متى
كذلكـ	كذلك
صـار	صار
عجِّل	عجل
الاغاني	الغناء
مثلَّث	مثلث
حَتَّىٰ	حَتَّى
قصه	قصة
ناااعم	ناعم
بالقرن	القرن
جيد	رديء
مطر،	مطر
حصةة	حصة
بعيدآآ	بعيدا
منعطفٍ	منعطف
رائحت	رائحة
​طفل	طفل
لُقمه	لقمة
تلقيها	تلقي
ناعمم	ناعم
جنونيّ	جنوني
والحاضر	الحاضر
دفـع	دفع
بالتاكيد	بالتأكيد
غدأ	غدا
ﺎجل	اجل
ومن…	ومن
عجيب	رهيب
والرقم	الرقم
الخلّابة	الطبيعة
زوووج	زوج
ألشباب	الشباب
‏‏إذا	إذا
شقق	شقة
دراجة	سيارة
أيَّ	أيّ
قؤل	قول
مقرف	مريع
نادرفي	نادر
فمه	فم
محتـاج	محتاج
معّين	معين
مسكينمن	مسكين
أكدّ	اكد
بسس	بسّ
اينمآ	أينما
جميع…	جميع
بسيطه…	بسيطة
الأقـل	الأقل
ينشغل،	مشغول
الكثي…	الكثير
اقامه	إقامة
شنيع،	شنيع
لمثلث	مثلث
انخفاض	ارتفاع
مُحرك	محرك
حديد؟	حديد
اللاكتوز	السكر
لوصول	وصول
الظحك	الضحك
السبب	سبب
عل	على
الخاضه	الخاصة
مرحلي	مماثل
خطوهہ	خطوة
حاد،	حاد
أوراق	ورقة
وبناء	بناء
،،علم	علم
آمينْ	آمينَ
،فيما	فيما
مليح؟	مليح
سئالة	ظرافة
البترول	الطاقة
فمِ	فم
العين؟	العين
المشكلة	مشكلة
يشتري	اشترى
ناااااعم	ناعم
أحد	احد
الاكسجين	الأكسجين
الخاصة،	الخاصة
كئييب	كئيب
آنتظر	انتظر
حيثُ	حيث
اححد	احد
سهوله	سهولة
متأخر،	متأخر
المُسليان	اللذان
نتيجتها	النتيجة
‏حين	حين
​​يوم	يوم
صيحة	صرخة
جنةذات	ذواتا
عِد	عد
الامتياز	امتياز
خيالى	خيالي
حصولنا	الحصول
تثبيث	تشغيل
متآخر	متأخر
انضمامها	انضمام
أوشكوا	أوشك
اللذينَ	اللذين
قآدره	قادرة
باتت	بات
فـو	فو
خاصّة	خاصة
الزجاج	زجاج
وعقدت	عقدت
برس\/	برس
العكسس	العكس
مقاعد	مقعد
تلبيتها	تلبية
التجربه	التجربة
سميّـك	سميك
وقالي	وقالت
الحصة	حصة
الأولي	الاولى
إشعارٌ	إشعار
‏بعد	بعد
الاحترافى	المثالي
النار…	النار
صرخات	صرخة
جدآر	جدار
ۈصف	وصف
شخصاا	شخصا
فاتن،	فاتن
عشررر	عشر
مخزً	مخزي
سواءاً	سواء
فتنوي	نتن
بالموسم	الموسم
أسود	أبيض
ليكم	لكم
زهــرة	زهرة
نحسسهم	نحس
اللواتي	اللاتي
همّ	هم
الأقلّ	الأقل
يسمح	سمح
صيحةٍ	صيحة
الاعلام	الصحافة
ﷺإياكم	إياكم
خكم	حكم
وخائن،	جائر
يضرب	ضرب
الثانية…	الثانية
فاااخر	فاخر
سيفينتين	تين
السمك	سمك
يسمع	سمع
الأنثوي	الرقيق
الفرحة	الفرح
آلبعض	البعض
لهاا	لها
فقدٺ	فقدت
قدم…	قدم
مززعج	مزعج
اسفه	آسف
؟عد	عد
اوف	اف
قَطّ	قطّ
بطرح	طرح
خاطأ	خاطئ
بمشهد	مشهد
عاماً…	عاما
أيآ	أيا
،ولا	ولا
وشرع	شرع
اختلفت	تختلف
الأسنان…	أسنان
توقّف	توقف
ألكلام	الكلام
اﻷنيق	الأنيق
أنشودة	قصيدة
والموسيقى	الموسيقى
الأورينت	الجزيرة
عسي…	عسير
العين…	العين
،جناح	جناح
تحتّ	تحت
الأساسية،	الأساسية
،أولئك	أولئك
شيء💜	شيء
ومقِيول	وَيْ
إنجاز	منجز
هناا	هنا
ملاسنة	مطاردة
مخجل	مؤسف
قواعد	قاعدة
أنَّى	أنّى
�من	من
🌹عجل	عجل
ساحه	ساحة
ككَل	ككل
عقود	عقد
شرير	خبيث
بسلسلة	سلسلة
قدييييم	قديم
لقطار	قطار
محزن	مؤسف
اللاتى	اللاتي
أياك	إياك
المتسبب	السبب
كلاهُما	كلاهما
مُنجز	منجز
صووت	صوت
تقنية_التعليم	تعليم
اليمٌ	أليم
فرقةة	فرقة
تقاطع	شارع
حتا	حتى
قاطع،	قاطع
رجـل	رجل
المٌقبل	المقبل
فى	في
لايجب	يجب
مؤهلة	آمنة
مايحدث	يحدث
ضدهم	ضد
رُبَ	رُبَّ
على…	على
وغالبا	غالبا
لكمم	لكم
سيّدة	سيدة
هناگ	هناك
نقي	نظيف
ومدينة	مدينة
خمسة	ثلاثة
متل	مثل
احتاج	محتاج
‏​تخيل	تخيل
إثار	أثار
بعيّد	بعيد
الى…	الى
لها،	لها
للبخار	البخار
وشارف	أوشك
عادّ	عاد
مكتوبہ	مكتوبة
ضربات	ضربة
الحارة،	الحارة
منہا	منها
تلبيه	تلبية
للحق	الحق
قزاز	زجاج
“ثمة	ثمّة
منأجل	أجل
وأكد	واكد
ستة	عشرة
لحجم	حجم
والمائية	التربة
تربد	تريد
السليم…	السليم
دونكك	دونك
لقيادة	قيادة
بالتربة	التربة
بقيةة	بقية
بالضبط…	بالضبط
الصحراء	صحراء
قووووي	قوي
الأساسيه	الأساسية
،هما	هما
مثااال	مثال
ملگة	ملكة
سَمعت	سمعت
النار💜	النار
وشمس	شمس
سكه	سكة
إيَّاك	إياك
اللوآتي	اللواتي
‏الصمت	الصمت
خفض	رفع
مرغ…	مرغوب
اخ	أخ
المساعده	مساعدة
شخصآ	شخصا
الاصلي	الأصلي
لمَّا	لمّا
ادخال	إرسال
مخطوطتان	اللتان
دائما…	دائما
رسالتة	الرسالة
بمحصول	محصول
دقيقةة	دقيقة
سااعه	ساعة
الموسم…	الموسم
گمال	كمال
بلاشك	بالتأكيد
التاسع	الثالث
،سريع	سريع
خطه	خطة
عاجلمجلس	مجلس
خدمة…	خدمة
مجهزة	جاهزة
شنيييع	شنيع
المظام	النظام
إنزلاق	انزلاق
آحد	احد
تُشير	تشير
أخِ	أخ
أختبار	اختبار
نجم	نجمة
تحسينـه	تخمين
تستوجب	تتطلب
ألفرح	الفرح
سعيد💙	سعيد
حزينّ	حزين
الخاصـة	الخاصة
مجرئ	مسار
بمنَ	بمن
نادر،	نادر
شَخْصًا	لَسْتَ
نزول	وصول
تركـ	ترك
مهين﴾	مهين
،حين	حين
مفهومهم	مفهوم
مميز	ممتاز
؟دراسة	دراسة
اجراس	جرس
عِلم	علم
أياهم	إياهم
قتله	قتل
نهائيات	نهائي
مُؤلم	مؤلم
نغس	نفس
ظهراً	ظهرا
أوتار	وتر
صغير…	صغير
‏اكل	أكل
صصار	صار
بالظبط	بالضبط
عاجلحالة	حالة
أبغضُ	أبغض
آسقاط	إسقاط
مسآلة	مسألة
اففف	اف
حددلي	حدد
سمييك	سميك
ربطةة	ربطة
طائرة…	طائرة
بحديقة	حديقة
دھن	دهن
هذ	هذا
آهه	آه
جديدية	جديدة
الكتف؟	الكتف
آعلى	أعلى
سماحهم	السماح
ايعادة	اعادة
حقير	قذر
لحـن	لحن
فترهـ	فترة
الحقل،	الحقل
البحر	النهر
مكتوبهه	مكتوبة
اياه	إياه
وامام	امام
مذكّرة	مذكرة
خوف…	خوف
قريةة	بحيرة
ألوقت	الوقت
المتوسط	متوسط
مُشرق	مشرق
باايخ	بايخ
بالقارة	القارة
رسالتي	الرسالة
اليل	الليل
المؤسم	الموسم
الضحية	ضحية
“عندما	عندما
وزنك	الوزن
انتِي	أنتِ
كلمةِ	كلمة
الأصلي،	الأصلي
النسا…	النساء
وغير	غير
صندووق	صندوق
حياةة	حياة
أستحالت	استحال
شــاهد	شاهد
او	أو
مدة	فترة
الدولار	الجنيه
اذاً	إذاً
قطع،	قطع
كمآ	كما
تجاه…	تجاه
التوست	الخبز
قطُ	قطّ
جزءء	جزء
وسيد	سيد
الفوز…	الفوز
مسار…	مسار
بلئ	بلى
البعض؟	البعض
رجعو	رجع
تطلبَ	تطلب
ايّ	أيّ
بَال	بال
لنا❤️	لنا
ولكن	لكن
محاولتها	محاولة
ووضع	وضع
ملحح	ملح
؟تحت	تحت
آيسين،	إياي
أنفق…	أنفق
ظرب	ضرب
حٌسن	حسن
العمررر	العمر
ومشرق	مشرق
خفيفة	ثقيلة
و10	و6
الابتسامہ	الابتسامة
حرب…	حرب
للموسم	الموسم
بتمر	تمر
أيًّا	أيا
مقصود❤️	مقصود
الواسع	واسع
متاخر	متأخر
مكروه”	مكروه
كثيراً	كثيرا
جاف؟	جاف
بِمَن	بمن
المشهوره	الشهيرة
ولايقارن	مقارنة
إياه💕	إياهن
محزن،	مفزع
ذهني،	ذهني
‏ممكن	ممكن
حطمو	حطم
كربه	كرب
الارقام	الأرقام
تعمين	تحسين
الطاقه	الطاقة
كلمۃ	كلمة
اي	أي
وحدهه	وحدة
لاهما	هما
يسجل	سجل
تجارةٌ	تجارة
ركضض	ركض
صديقة	صديق
السوال	السؤال
كَانت	كانت
اماام	امام
شَخص	شخص
بسرعة”	بسرعة
الدماء	الدم
رموز	رمز
اثم،	أثم
عسسى	عسى
طقس	الطقس
دقيقہ	دقيقة
ورقت	ورقة
الذهن	ذهني
صووووت	صوت
شرّاب	شراب
أقبلَ	أقبل
الطبيب،	الطبيب
حالياًً	حاليا
محطّة	محطة
اختبارر	اختبار
اثار	أثار
مرّه	مرة
👈ما	ما
إليك	إليكَ
باطلمجموع	باطل
بتألق	تألق
تبدل	تبدّل
والجبسيات	الطلاء
بِضع	بضع
شاطئ	الشاطئ
قائلا	وقالت
طيارة	طائرة
هولاء	هؤلاء
اربعه	أربعة
مهين﴿١٤﴾	مهين
الضضحك	الضحك
مووجع	موجع
اقتناء	ارتداء
سّكة	سكة
أنتو	أنتم
صالح…	صالح
كلاً	كلا
🔴مكتب	مكتب
كيفَ	كيف
غريب،	غريب
كامل…	كامل
الذينا	اللذين
الشرق…	الشرق
آخرى	اخرى
مكانكُم	مكانكم
جداار	جدار
صباااح	صباح
أمسَى	أمسى
الكل،	الكل
مفاتيح	مفتاح
الرّبيع	الربيع
جوعانفكت	وقالت
يگون	يكون
طوييل	طويل
عقده	عقد
عِوَض	عوض
السّاق	الساق
عملنا	عملي
أرتداء	ارتداء
ورسم	رسم
صفر،	صفر
فستانها	فستان
••ما	ما
أسفه	آسف
اللآتي	اللواتي
آما	أما
،هو	هو
‏طريقة	طريقة
الاخشاب	الخشب
فـ	ف
وطرح	طرح
إستغرق	استغرق
باستخدام	بواسطة
تتلقى	تلقي
إحسااس	إحساس
نووووم	نوم
وكوكب	كوكب
التجربه،	التجربة
زراكون°درجة	درجة
استخدامه	استخدام
أثر…	اثر
دقيقة،	دقيقة
شـــــــاهد	شاهد
ثلاثة	ثمانية
عَمَّ…	عَمَّا
نِّعْمَ	نِعْمَ
إذا	اذا
المعهد	القسم
شقيق	شقيقة
المادة	مادة
الاطفال	الأطفال
ربطھ	ربطة
مطالبات	مطالبة
مهموم،	مكروب
ريئس	رئيس
وهى	وهي
اتيار	التيار
بالجانب	الجانب
تبرز	تظهر
الايميل	الرقم
عامة،،	عامة
أُرسلت	أرسلت
،عند	عند
أختر	اختر
شارعي	شارع
نقبل	أقبل
الحآره	الحارة
بالضب…	بالضبط
يحققون	تحقق
نِعم	نعم
‏​جدول	جدول
طفله	طفل
قديم،	قديم
كاااملة	كاملة
مخبم	مخيم
الصحيفة	الصحافة
حرف💔	حرف
انتطر	انتظر
رتّب	رتب
تجعّد	تجعد
أنت…	أنت
المصنوعه	مصنوع
معهود	معتاد
حَافة	حافة
وترٍ	وتر
ثلاثة	خمسة
الحاره	الحارة
السليم،،	السليم
الأنيـق	الأنيق
بورق	ورق
الكلية	المدرسة
حبلِ	حبل
ﺎسنان	أسنان
انتن	أنتن
العحب	عجب
وجه…	وجه
الشماال	الجنوب
‏​‏​مقطع	مقطع
ألذي	الذي
خطوة،	خطوة
بهاا	بها
إنتِ	أنتِ
المستوى	مستوى
مطاردات	مطاردة
إيَّاك	إياك
حولَ	حول
‏بداية	بداية
جديدفطائر	جديدة
تعتمدين	تعتمد
إراد	أراد
شاااق	شاق
الآصلي	الأصلي
أثر	اثر
انهآ	انها
بمـا	بما
هاكذا	هكذا
الدولار؟	الدولار
وَصف	وصف
مبسمهما	إياهما
،كان	وكان
فوووق	فوق
ۈقد	وقد
،هل	هل
والشاطئ	الشاطئ
ضِعف	ضعف
لنّا	لنا
تللك	تلك
ماشرع	شرع
أيضاً	ايضا
اللاتى	اللواتي
بعيداعن	بعيدا
البحر؛	النهر
أوشكت	أوشك
_جعل	جعل
فالموسم	الموسم
الجدوال	الجدول
،تعلم	تعلم
اربعة	سبعة
بنآ	بنا
طبعاً	بالطبع
بأسفل	أسفل
أنتظر	انتظر
شخصأ	شخصا
المتفهم	المثالي
بأرتداء	ارتداء
أكد	واكد
هنالك	هناك
مفاجاه	مفاجأة
جيراننا	الجيران
عاماً؟	عاما
عجلات	عجلة
وبسبب	بسبب
قرآ	قرأ
سفركم	السفر
جلبتم	جلبت
بالزبط	بالضبط
المساعدة	مساعدة
بين…	بين
\/مع	مع
مازالتا	اللتان
بها”	بها
الفووووز	الفوز
يركض	ركض
المدينه	المدينة
كَ	ك
القدم…	القدم
الصفقة	صفقة
كيندل	كيت
“ثلاثة	ثلاثة
وعرف	عرف
الييم	أليم
اامام	امام
عجبّ	عجب
والوقوف	الوقوف
الفئات	الفئة
هّب	هبّ
محبَوب	محبوب
فئة	الفئة
انتاج	إنتاج
فيها♡	فيها
صعف	ضعف
نعم،	نعم
هنا،	هنا
نوعمن	نوع
بتوقف	توقف
اكدو	اكد
كرب،	كرب
وسوف	سوف
آلعالم	العالم
فاتں	فاتن
صار	بات
دوُني	دوني
وحقيقة	حقيقة
بفقرة	فقرة
گيف	كيف
•يوم	يوم
اجمّع	أجمع
الحارهه	الحارة
الاجابه	الجواب
هياا	هيا
أصبح	أضحى
لئِن	لئن
سبُحان	سبحان
حيثلا	حيث
محرّك	محرك
عُبوس	عبوس
مجوعة	مجموعة
المغشـوش	الجبل
إيآه	إياه
طاقيه😜	طاق
مُبهج	مبهج
عليك❤️	عليك
فوز	الفوز
مفاجآة	مفاجأة
اعضم	أعظم
صاطع	ساطع
آسود	أسود
ضرب…	ضرب
لي💎	لي
بخطة	خطة
لنا…	لنا
مخيس	فخم
‏عند	عند
مروع	مريع
وسسسسيم	وسيم
بطيىء	بطيئة
تتوقع	توقع
العيـن	العين
‏لماذا	لماذا
الالومبية	الرئيسية
‏اول	اول
عميييق	عميق
شككل	شكل
البنك،	البنك
“خلية	خلية
شاق،	شاق
بهيئة	هيئة
طائرات	طائرة
قاعوأصبح	قاع
بمن…	بمن
آسفهه	آسف
تلقأ	تلقاء
يتبغي	ينبغي
لكُم	لكم
خلى	خلا
التشميس	الجلد
وصديق	صديق
وقصة	قصة
الفعلو	الفعل
نتمني	نأمل
يقرف	مقرف
عبوس؟	عبوس
“إسقاط	إسقاط
تخمينوعيد	تخمين
لاتذهب	تذهب
الأرض،	الأرض
والولاده	الولادة
عجييب	عجيب
أف	اف
وعجل	عجل
الأطف…	الأطفال
مرعب	مريع
موكد	مؤكد
ورقص	رقص
قآدرة	قادرة
ضمنت	تضمن
الان	حاليا
ومذ	مذ
شاااااق	شاق
اااف	اف
“الملتقى	القسم
كلتَا	كلتا
قديم؛	قديم
هى	هيا
،طريق	طريق
مـيل	ميل
كاانت	كانت
اخرئ	اخرى
اشكالية	مشكلة
شريعة	شرع
بحَر	بحر
مسكين،	مسكين
الفاحش	فاحش
مابين	بين
امّا	إمّا
أول	اول
بلعبة	لعبة
آلوصول	الوصول
حمارة	بقرة
الحراره	حرارة
،،،ولم	ولم
‏‏عندما	عندما
إمرأة	امرأة
كلمـة	كلمة
كآنت	كانت
النفسي	الذاتي
يحدُث	يحدث
بمَا	بما
الوزن،	الوزن
للمعرض	المعرض
هناگ	هنالك
انشأنا	أنشأ
طاقة	الطاقة
إيآهآ	إياها
موبؤ	مشؤوم
عصاء	عصا
فووق	فوق
وضعه	وضع
الحق…	الحق
بيق	تين
البحث…	البحث
ووحشي	وحشي
كربت…	كرب
وختلفت	تختلف
حِجْر	حجر
بأاسم	باسم
ساحات	ساحة
_قال	قال
الضّرورة	الضرورة
ممتازة	ممتاز
تجارب	تجربة
مادة…	لاحقة
الووقت	الوقت
ابداً	أبدا
گره	كره
سلسله	سلسلة
ثُمّ	ثمّ
خمسة	عدة
انفق	أنفق
فهلاّ	هلّا
ابنُ	ابن
كانت	وكانت
حالياً	حاليا
وسوق	سوق
دعوهہ	دعوة
بمّن	بمن
بـمن	بمن
قليلة	قليل
تشير…	تشير
الخامس	الثاني
جذّاب	جذاب
آي	اي
دولة	بلد
سفينه	سفينة
السيروم	الجلد
مثيير	مثير
تساوية	مساواة
الأكل	أكل
إلى…	إلى
‏ثلاثة	ثلاثة
ٰعدد	عدد
تفووق	تفوق
يتوجب	يجب
مطارده	مطاردة
لولآ	لولا
ماسجل	سجل
اثين	اثنين
بدلاً	بدلا
تعيس	رديء
آين	أين
،هَؤلاء	هَؤلاء
قاطِع	قاطع
فيما…	فيم
الأُلى	الألى
عَدا	عدا
البيبسين	الجذر
عبوُس	عبوس
بفرع	فرع
و…	و
يديدة	جديدة
قتلوا	قتل
امينَ	آمينَ
​قد	قد
بالحاجاتاوقبل	السائل
ستة	سبعة
بزوج	زوج
النظا…	النظام
فااتن	فاتن
،،عندما	عندما
حصص	حصة
االف	الف
،بري	بري
متأخره	متأخر
تحسون	تحسين
عليكي	عليك
عليلٍ	عليل
أسمر،	أسمر
السببب	السبب
بنا”	بنا
نووم	نوم
رسمت	رسم
يكاد	كاد
صعب	الصعب
الريآح	الرياح
حاشى	حاشا
أشتعلت	اشتعلت
الشماسيه	الوادي
سماحها	السماح
غداا	غدا
عقدٍ	عقد
اكد	واكد
اشتريت	اشترى
كثير…	كثير
وكتاب	كتاب
والكل	الكل
سنـة	سنة
اطفالنا	الأطفال
مفـتاح	مفتاح
آلنظر	النظر
الآخيرة	الاخيرة
ضيئ	ضوء
يقرأ	قرأ
زائف،	زائف
كصرخة	صرخة
بها💔	بها
﴿لئن	لئن
الأخيرةالتي	اللتين
جاءَ	جاء
سما	سماء
‏​قال	قال
حااصل	حاصل
وبري	بري
الردد	الرد
كثييييير	كثير
الآن	الان
بوسط	وسط
مَن	مَنْ
بعيدآ	بعيدا
الجبههه	الجبهة
سفن	سفينة
فيديوشاحنة	شاحنة
مرِح	مرح
أسطوح	سطح
«جندي	جندي
امتدادٌ	امتداد
ابريل	مايو
الطقس_اليوم	الطقس
وجنوني	جنوني
سابقاً	السابق
گلتا	كلتا
•جعل	جعل
وسـط	وسط
وتحدثه	وتحدث
​تخيل	تخيل
وشعر	شعر
جلب…	جلب
آكثر	اكثر
بانها	انها
الصلصات	البخار
التصبغ	الجلد
اياها	إياهم
عشر	عشرة
الورق	ورق
وصندوق	صندوق
بجبل	جبل
مفاجى	مفاجئ
بتوجيه	توجيه
🔴الحشد	الحشد
‏كانت	وكانت
طفلة	طفل
يرغب	رغب
مكان…	مكان
الساقُ	الساق
مخزٍي	مخز
ألييم	أليم
المدمي	الصلب
باردد	بارد
خطورة	خطر
استشراء	انتشار
بليون	مليون
أنضمام	انضمام
مؤكدة	مؤكد
وانقلب	انقلب
تفلييم	تخمين
كيفمآ	كيفما
يبدا	ابتدأ
بطائق	بطاقة
هااا	ها
هاكِ	هاكَ
منفصلة؟	منفصلة
ضدّ	ضد
علاامة	علامة
مميز🌹	متميز
العٌمر	العمر
وصناعة	صناعة
سيطرتهم	السيطرة
الطريق	طريق
بمقارنتها	مقارنة
الشباب؟	الشباب
دقيق،	دقيق
الجيران،	الجيران
رعاية	الرعاية
ردئ	رديء
اللآتي	اللاتي
موسف	مؤسف
حروب	حرب
1مليون	مليار
همّا	هما
الشباب،	الشباب
رحلہ	رحلة
يجمع	جمع
وتجارة	تجارة
هاذه	هذه
آيام	ايام
،قد	قد
بصوتَ	بصوت
ممتاز،	ممتاز
الجهة	الجانب
لدعم	دعم
​يوم	يوم
حازم	عادل
🔴مشهد	مشهد
خااارج	خارج
“غالباً	غالبا
عدونا	العدو
الگل	الكل
مآئة	مائة
خلقٰ	خلق
الدولية؟	الملكية
وممارسة	ممارسة
لديها	لدينا
ألآ	ألا
بيسمح	سمح
وصوول	وصول
أنيقّ	أنيق
ذَا	ذا
البورسلان	الطلاء
تمآمآ	تماما
ايطار	إطار
الإبتسامة	الابتسامة
وحكم	حكم
سيطرتها	السيطرة
ولأضلن…	ويكأنّ
‏فن	فن
القَليل	القليل
بعييد	بعيد
تجار	تجارة
منذٌ	منذ
يسَّرَه۞ثُمَّ	ثُمَّ
الموض…	الموضوع
لميزة	ميزة
سمِعت	سمعت
ثُم	ثم
الجبه	الجبهة
آناقة	أناقة
فقدتَ	فقدت
؟بل	بل
سيشتري	اشترى
جدولنا	الجدول
فرع	مركز
الرجا…	الرجال
الطاقة…	الطاقة
ومرح	مرح
وها	ها
اللون	لون
استراحه	استراحة
الّذي	الذي
ذاتِ	ذات
خااصة	خاصة
تذه…	تذهب
أيَّ	أيّ
فضيلة…	فضيلة
احد💙	احد
‏مع	مع
محطتين	محطة
فقط،	فقط
المقليات	الفاكهة
المساء	الصباح
كتااب	كتاب
أيّا	أيا
أرقام	الأرقام
مقارنت	مقارنة
ف	فى
خيالي،	خيالي
صفقه	صفقة
تذّكر	تذكر
بندقيه	بندقية
نااعم	ناعم
بتسلق	تسلق
خلااا	خلا
مَريض	مريض
ضربتين	ضربة
الماضي؟	الماضي
فوووز	فوز
معا،	معا
مزارع	مزرعة
رابعاً	رابعا
الحصان؟	الحصان
‏عادل	عادل
أشترى	اشترى
بآت	بات
اللهاة	الذراع
بالتاريخ	التاريخ
له🍃	له
شخصاً	شخصا
🔴سحب	سحب
الناس…	الناس
بمستقبا	مشرق
بااب	باب
النار”	النار
عبقري،	عبقري
الشتا	شتاء
وقوفك	الوقوف
قُتل	قتل
فنون	فن
كلاهماا	كلاهما
‏الحب	الحب
خطيرر	خطير
الحركة…	الحركة
وميزة	ميزة
مرزعة	مزرعة
الحشد…	الحشد
االبحث	البحث
بما…	بما
متجاوب	متوافق
مساعدت	مساعدة
نحيف	وسيم
،،،ما	ما
السفر…	السفر
ومصنوع	مصنوع
لاختيار	اختيار
برس|	برس
‏​لن	لن
قَرب	قرب
إثر	اثر
٦قطعه	قطن
مفاجئ،	مفاجئ
سهولةة	سهولة
بدعم	دعم
خااااص	خاص
سفنية	سفينة
الفخد	الكتف
لموقف	موقف
لاسم	اسم
الخلف❗	الكتف
تِسعة	تسعة
ماتناسب	تناسب
عبوس،	عبوس
عبور💙	عبور
السؤال،	السؤال
إستعمال	استخدام
ولينة	لينة
ألفف	الف
الغالب	غالبا
وتجربة	تجربة
فتره	فترة
معيّن	معين
مسألہ	مسألة
بتوفير	توفير
الماضي،	الماضي
شَمس	شمس
آسفل	أسفل
ألف…	ألف
ألحكم	الحكم
مفاجىء	مفاجئ
لماا	لما
آمينّ	آمينَ
قوول	قول
ايادي	يد
شكراً	شكرا
بِذرة	بذرة
هماا	هما
‏تريد	تريد
طووويل	طويل
لساحبة	سحابة
وطالما	طالما
الطريق	المسار
شرعه	شرع
مركز	فرع
وستحدث	وتحدث
،،كي	كي
حقيقية…	حقيقية
دخولهم	دخول
آلكثير	الكثير
أكثرمن	أكثر
“كم	كم
سجّل	سجل
ارآد	أراد
إياكَ	إياك
المعنئ	المعنى
عزيرتي	عزيزتي
اﻻت	لات
الانف	الأنف
مفأجاة	مفاجأة
صحيح…	صحيح
الكلاام	الكلام
المواجهة	المعركة
السرعة”	السرعة
ﺎلنظر	النظر
ﺎنيق	أنيق
تحدث	وتحدث
واثار	أثار
التاري…	التاريخ
انہا	انها
أمامكك	أمامك
لمشهد	مشهد
حَول	حول
برّي	بري
،وكانت	وكانت
،لاحول	حول
‏‏ما	ما
اعطئ	أعطى
الجيراان	الجيران
بي؟	بي
سميگ	سميك
المثالي،	المثالي
اسفاط	إسقاط
الثالث	الأول
«بعد	بعد
وحيدآ	وحيد
بميزة	ميزة
،وكان	وكان
بمجموعة	مجموعة
الاشنابوجانا	الرجال
صناعت	صناعة
مباااشرة	مباشرة
قطاعي	قطاع
بقيةْ	بقية
لديهم	لديه
حرُ	حر
أبقـى	أبقى
نِتاج	نتاج
فنَ	فن
معطَفِ	معطف
سبباً	سبب
عّد	عد
المغزى	المعنى
القياام	القيام
الأوّل	الأول
وموقف	موقف
،وهي	وهي
هُن	هن
وإيّاكم	إياكم
اوراق	ورقة
شخصاُ	شخصا
فرصة…	فرصة
مطالبتها	السماح
سنةة	سنة
تاسعا	رابعا
يفزعني	مفزع
كتشاف	اكتشاف
فااخر	فاخر
إليككك	إليكما
أنتَ	أنت
الطريفة	الشهيرة
الأسنان	أسنان
أنابيب	أنبوب
خطوة…	خطوة
بك💖	بكن
عليها❤️	عليها
ترسل	أرسلت
ويسطع	ساطع
إليکَ	إليكَ
طآلما	طالما
الّذين	اللذين
بمَن	بمن
بالقيام	القيام
حفظِ	حفظ
خارح	خارج
وسجل	سجل
رفيع”	رفيع
قلبِ	قلب
سقوط	إسقاط
فترهہ	فترة
وهو…	وهو
لجبل	جبل
اينما	حيثما
صرخةُ	صرخة
بكلتا	كلتا
سمعتُ	سمعت
دام	مادام
الأولى…	الاولى
ھادئ	هادئ
سبعة	تسعة
ررركض	ركض
أعطَى	أعطى
السنور	القط
خلقَ	خلق
حالةة	حالة
حِلو	حلو
الوصول…	الوصول
دفع…	دفع
خييير	خير
مشكل…	مشكلة
لأرض	أرض
القليل🌹	القليل
المصطلحان	اللذان
الحشدالشعبي	الحشد
حقيقية،	حقيقية
أبد…	أبدا
آلعبارة	العبارة
ثمَ	ثمّ
بهواء	هواء
معركة	المعركة
ومقدس	مقدس
انهإ	انها
يتم	تم
تلگ	تلك
جوله	جولة
عقوبات	عقوبة
••إن	إن
قانون	القانون
امراة	سيدة
أدات	أداة
قولً	قول
،لو	لو
النساﺀ	النساء
يوافق	توافق
تسلكهعليك	كليكما
مشارف	حافة
كااد	كاد
اكشاف	اكتشاف
خاج	خارج
دقيقتين	دقيقة
،تواصل	تواصل
العليل♡	عليل
قدمو	قدم
مريب	مخيف
ركوبه	ركوب
ايضاء	ايضا
مقاابل	مقابل
خياالي	خيالي
سامج	بايخ
بالجنوب	الجنوب
؛البعض	البعض
لك✨	لك
ترليون	مليون
دولتنا	دولة
اياام	ايام
قطعةٌ	قطعة
الأرقام…	الأرقام
صباحأ	صباحا
اربك	أربك
المناسب	المثالي
مليون	مليار
الذهب…	الذهب
ومحتاج	محتاج
ااخر	آخر
آيّ	أيّ
الرياضات	السباحة
الكثييير	الكثير
الأسبوع	الموسم
حرباً	حرب
اسفل	أسفل
مكروة	مكروه
باسمه	باسم
هيااااا	هيا
‏ومن	ومن
وُصف	وصف
مواقف	موقف
سعيدة،	سعيدة
اللّذين	اللذين
لايطير	يطير
إينما	حيثما
الدولة	دولة
بطاقه	بطاقة
الحانب	الجانب
اسسم	اسم
آلعين	العين
عسا	عسى
وخلال	خلال
بصوٺ	بصوت
بغرفه	غرفة
له💞	له
أمامي	أمامك
بقيہ	بقية
مجاس	مجلس
لابد	يجب
احمر؟	أحمر
سير|	سير
ماصار	صار
الشرق،	الشرق
‏​لم	لم
ارجو	الرجاء
الشعر،	الشعر
أينما	حيثما
ملامسة	لمس
اتنين	اثنين
بحفظ	حفظ
دقيقه	دقيقة
رطباً	رطب
وكآن	وكان
صوره	صور
لوضع	وضع
الصمّت	الصمت
طوييييل	طويل
مرروي	مروع
👈راقب	راقب
علب	علبة
الحارّه	الحارة
؟؟لماذا	لماذا
سبعة	أربعة
السبب…	السبب
ونتمنى	نأمل
السرعة،	السرعة
لمّاا	لمّا
به💜	به
أمراة	امرأة
نفسه🌷	نفسه
أمرأة	امرأة
يعقد	عقدت
نبتة	بذرة
ووسيم	وسيم
كـي	كي
الموسيقئ	الموسيقى
طالماً	طالما
اجل…	اجل
“كلا	كلا
رمى	رمي
تحديد	حدد
إذا؟قال	إذاً
اضافه	إضافة
آداة	آلة
دونك،	دونك
حلـم	حلم
البعض،	البعض
خلف…	خلف
،نظيف	نظيف
؛وفي	وفي
تَعلم	تعلم
يد	بيد
💞إن	إن
العمل؛	العمل
بنامن	بنا
علبہ	علبة
ربطه	ربطة
تمرّ	تمر
ثم	ثمّ
يحطم	حطم
عشّر	عشر
عسىَ	عسى
قدمت	قدم
جبال	جبل
المااضي	الماضي
قَول	قول
النار💗	النار
يرجع	رجع
شديدة	شديد
أنه	انه
الدعم	دعم
وتطوير	تطوير
مُباراة	مباراة
الكُل	الكل
مُشابه	مماثل
فكرة…	فكرة
مكروه🌹	مكروه
عليها”	عليها
جواب	الجواب
_قد	قد
أنتي	أنتن
يحرق	حرق
آميينّ	آمينَ
الحرب	المعركة
ان	أن
االبعض	البعض
مباااشر	مباشر
اياه😢	إياهن
مؤلمٌ	مؤلم
الماضي،،،	الماضي
فمہ	فم
طريقةة	طريقة
بطايق	بطاقة
لشارع	شارع
‏اذا	اذا
مذكره	مذكرة
تنمُو	تنمو
الرجال”	الرجال
احمر،	أحمر
مساندة	مساعدة
ثمَّ	ثمّ
الفرَح	الفرح
فأين	أين
يذهب	ذهب
مُخزي	مخزي
كُلّما	كلّما
بابَ	باب
هاائل	هائل
،وقال	وقال
لجدار	جدار
وحيَّ	حيَّ
التزلج	السباحة
مواضيع	موضوع
عِند	عند
انخفض	ارتفع
تفسه	نفسه
الحاااره	الحارة
علامة…	علامة
حرررف	حرف
بك💞	بك
،لولا	لولا
ماسمح	سمح
الكريم،و	الألى
رئيسيّ	رئيسي
وااا	وا
صيف	الصيف
عمييق	عميق
يقوم	قام
وضمن	ضمن
لائحة	قائمة
حّر	حر
بحث…	بحث
تحصل	حصلت
اذاً	إذن
بعد…	بعد
مريض،،	مريض
طلاب	طالب
آﻵقل	الأقل
غريب	عجيب
التقريبي	المثالي
حححلم	حلم
الردارات	السرعة
بإرسال	إرسال
سقطت	سقط
يحتاجون	تحتاج
الحُب	الحب
مااذا	ماذا
اعطى،	أعطى
ممارسته	ممارسة
المائه	المائة
وشديد	شديد
فيھا	فيها
يكلم	كلم
“حفظ	حفظ
رميه	رمية
أعنتهأوحزين	حزين
خيالك	خيالي
اذن	إذن
وملح	ملح
الرجآل	الرجال
مِمَن	ممن
خخلق	خلق
بعيداً	بعيدا
كاملةً	كاملة
سنوات،	سنوات
أسفلِ	أسفل
المقبل،	المقبل
كوكوب	كوكب
آلفضاء	الفضاء
كريم،	كريم
سخيف	ظريف
مصلحه	مصلحة
الأول…	الأول
أخ،	أخ
الفرصة	فرصة
أتصال	اتصال
خاائف	خائف
الذهب،،	الذهب
أثر	تأثير
هوه	هو
لشراء	شراء
مزعج،	مزعج
الصبآح	الصباح
أليـم	أليم
‏​قبل	قبل
الفريقيان	اللذان
عسئ	عسى
لحضة	لحظة
ربمآ	ربما
مُزعج	مزعج
الممال	المال
الأولى	الاولى
هم…	هم
إِثم	أثم
منحووس	منحوس
بطئيه	بطيئة
ومقعد	مقعد
آلفرح	الفرح
والربيع	الربيع
اسمراني	أسمر
البقية	بقية
التاسعة	الثانية
بالاستماع	استمع
إثم،	أثم
لـعمر	لعمر
بشكلاً	بشكل
لكنَّما	لكنَّما
‏عائلة	عائلة
بمحطة	محطة
أولئكَ	أولئك
فرص	فرصة
اربعة	تسعة
ملللح	ملح
الأصبع	إصبع
شخِص	شخص
خـلا	خلا
إيّاها	إياها
​بين	بين
،بل	بل
حلصت	حصلت
كتله	كتلة
گثيرا	كثيرا
وحدد	حدد
الليوم	اليوم
مباراتي	مباراة
منذ…	منذ
بسرعة…	بسرعة
🍃كل	كل
شكوى	دعوى
شااق	شاق
القراص	الجذر
مفتوح	مفتوحة
مكانتس	مكانكم
واجرامي	وحشي
عضوان	عضو
الصييف	الصيف
حزيں	حزين
الجاانب	الجانب
تُبدّل	تبدّل
نصف…	نصف
سعيدةة	سعيدة
والشباب	الشباب
مقتل	قتل
لونعبر	لون
تهمناتواصل	تواصل
مُذ	مذ
خرائط	خريطة
شي	شيء
الحكم…	الحكم
‏هناك	هناك
‏ألا	ألا
طلبة	طالب
ككككل	ككل
اللعبة	لعبة
الﻵتي	اللاتي
بضعِ	بضع
اللفة	لفة
مذ	منذ
‏​هل	هل
فيه💛	فيه
هاؤلاء	هؤلاء
بشكلا	بشكل
منعرج	منعطف
زهرةة	زهرة
بركن	ركن
وجلبت	جلبت
رئيسي…	رئيسي
أميــــن	آمينَ
باضيفه	حاي
عاجل🔴وكالة	لوكالة
تيار	التيار
تافة	تافه
خيـالي	خيالي
تهمتي	تهمة
الاضد	ضد
شجرة،	شجرة
ااذن	إذن
دعوهـ	دعوة
وكتلة	كتلة
مسألـۃ	مسألة
إشترى	اشترى
تحسّين	تحسين
مشرقا	مشرق
الذّهب	الذهب
امرأه	امرأة
تسلّق	تسلق
كتبت	كتب
كذا☺	كذا
طوووول	طول
يكووون	يكون
القدم”	القدم
العمر،	العمر
‏عندما	عندما
،،أما	أما
نظيفة	نظيف
سابقة…	لاحقة
«أعظم	أعظم
رُب	رُبَّ
خاطئ…	خاطئ
ألان	الان
وعين	عين
مُعطف	معطف
لَيتَ	لَيْتَ
الميتتان	اللتان
الوزن؟	الوزن
أخٌ	أخ
أعظ…	أعظم
اعاده	اعادة
اللذي	الذى
بعييييد	بعيد
عليهاا	عليها
النسساء	النساء
أضافه	إضافة
فاضح”	فاضح
اقضل	أفضل
صاار	صار
سريعة	بطيئة
جناج	جناح
العرض…	العرض
ميّت	ميت
لمآ	لمّا
جدأ	جدا
أياه	إياه
وغسل	غسل
​عند	عند
وتقرر	تقرر
إنبوب	أنبوب
أرتفع	ارتفع
متىى	متى
فضيع	شنيع
اللغه	اللغة
مثالى	مثالي
وانتم	أنتم
عن…	عن
هادىء	هادئ
شخصاً،	شخصا
كلتاا	كلتا
عائلات	عائلة
وقصير	قصير
بمزرعة	مزرعة
قاااع	قاع
ذرةً	ذرة
تكلم	كلم
ابتدى	ابتدأ
نوووم	نوم
بنهاية	نهاية
شَآءَ	سَاءَ
باارد	بارد
بالرد	الرد
العبارهہ	العبارة
سعيده	سعيدة
الرّياح	الرياح
مُطْمَئِنَّه	أَنَّ
اناقة	أناقة
أرضّ	أرض
فيالمنزل	المنزل
خخيالي	خيالي
برفع	رفع
شاحنتين	شاحنة
القطوو	القط
نهاي…	نهاية
ودخول	دخول
علامات	علامة
❤️لم	لم
بختلف	اختلف
تافہ	تافه
الجَمال	الجمال
رتفع	ارتفع
وَصَرَّفْنَا	هَيْهَاتَ
الأموال	المال
ﻻزال	مازال
اللائى	اللاتي
ثمَّة	ثمّة
السرعه😂	السرعة
اقوول	أقول
منخض	منخفض
سيء	جيد
الاول	الأول
مُتأسفه	متأسف
الجص	الطلاء
فضييييع	فظيع
ونعم	نعم
بأرض	أرض
كريم…	كريم
القطو	القط
حادفي	حاد
ثٌم	ثمّ
كهربائي،	كهربائي
عمود…	عمود
ناتج	نتاج
يكتب	كتب
الدولا	الدولار
تُناسب	تناسب
بمتجر	متجر
الإ	إلا
مروري	مروع
ضؤ	ضوء
اتريا	انتظر
وصوله	الوصول
عشَر	عشر
متوحش	وحشي
آسف	أسف
ظعف	ضعف
شبهـ	شبه
بآل	بال
يَاأيُّهَا	لَسْتُنَّ
أسمراً	أسمر
مشغُول	مشغول
انتِ	أنتِ
ألفَ	ألف
ثاتي	ثان
اصباع	إصبع
معآ	معا
تمام…	تماما
اسفة	آسف
وباب	باب
عدد…	عدد
التربه	التربة
عظيم،	عظيم
غضـب	غضب
الركوب	ركوب
انة	انه
الغابة	الغابات
بتمثيل	تمثيل
الاخضر…	الأخضر
حُفره	حفرة
نافذه	نافذة
ايسر…	أيسر
الأصفر	الأزرق
‏​اذا	اذا
خامسا	رابعا
الحراك	التيار
ننتظر	انتظر
وحيدا	وحيد
تماماً	تماما
هيااا	هيّا
واي	إي
إختبار	اختبار
ميت،	ميت
نجااح	نجاح
آلقليل	القليل
وذهب	ذهب
عملى	عملي
ذاگ	ذاك
تواص…	تواصل
أليكم	إليكم
ونادم	نادم
وكلم	كلم
به✨	به
سنہ	سنة
ملكه	ملكة
؟ها	ها
ﺎلف	ألف
ألّا	ألا
وهيا	هيا
هيئہ	هيئة
وكان…	وكان
الاموال	المال
باالاحرى	بالأحرى
إياها﴿و	إياهما
هُما	هما
الفئة؛	الفئة
تفاحهه	تفاحة
بطط	بط
بسَ	بسّ
بذئ	بذيء
الصّباح	الصباح
ذأ	ذا
بفريق	فريق
طآئر	طائر
الشرآع	الشراع
عقبري	عبقري
الفضَاء	الفضاء
وإقامة	إقامة
يطالب	مطالبة
مصلحته	مصلحة
مشغوووول	مشغول
الحركة،	الحركة
والتي	التى
عليك،	عليك
بارتداء	ارتداء
نقيبة	نقيب
قريباً	قريبا
مُقدس	مقدس
مليحح	مليح
تذهب…	تذهب
رهييييب	رهيب
سريييع	سريع
الانخفاض	الارتفاع
رطبآ	رطب
الوحيدتان	اللتان
الصباح،	الصباح
طب_الاسنان	أسنان
وقطار	قطار
نفسهه	نفسه
سألبي	تلبية
رُبٓ	رُبَّ
بيرتفع	ارتفع
واختر	اختر
الفاكهه	الفاكهة
الآن…	الآن
فاضح🌸🍃	فاضح
وعلق	علق
شديد،	شديد
عاجلوصول	وصول
به💕	به
منحيث	حيث
مفجع	مفزع
مميزات	ميزة
لكم…	لكم
فيه💕	فيه
أينمَا	أينما
متطابق	متوافق
يحصل	يحدث
النتيحة	النتيجة
الفضاء…	الفضاء
كلآهما	كلاهما
دونك…	دونك
هذاء	هذا
افضل	أفضل
تضرب	ضرب
اﻷول	الأول
أبتداء	ابتدأ
الخاصه	الخاصة
حُلم	حلم
أسم	اسم
گان	كان
مولم	مؤلم
وأنتن	أنتن
أكتشاف	اكتشاف
أيضا	ايضا
قطع	قاطع
باطلمقتبس	باطل
ملكة	ملك
ومنحدر	منعطف
«تطوير	تطوير
فيه…	فيها
آلصمت	الصمت
غربب	غريب
نغمت	نغمة
معهد	مركز
واسم	إسم
اخر	آخر
فعل”	فعل
مرعب	مزعج
غتيت	كتكوت
،،إما	إمّا
الآول	الأول
بقيادة	قيادة
وأسود	أسود
ومثير	مثير
الجليد،	الجليد
شغا	شغل
فخخخخم	فخم
شآق	شاق
غداً	غدا
بناوي	نادم
رطــب	رطب
۞گلا	كلا
وأخذ	أخذ
اخت	أخ
فهلّا	هلّا
الشرع؟	شرع
حصتين	حصة
ممَّا	مما
حسّاس	حساس
عقله	عقل
ومحطة	محطة
به💗	به
فيه…	فيه
مفتوحة…	مفتوحة
تتحول	تحوّل
الكبری	الكبرى
المال؟	المال
إلا…	إلّا
احتدمت	اشتعلت
الدورة_الشهرية	الولادة
،سمع	سمع
صبآح	صباح
سيِّد	سيد
خير😂	خير
💙♥💙رقص	رقص
ثلجة	ثلج
هٰذه	هذه
الكلااام	الكلام
ذآك	ذاك
ARGهيا	هيّا
يعَتقد	يعتقد
•دعم	دعم
يحدث	تحدث
أَصبح	أصبح
سلبي؟	سلبي
بٲن	بان
الاوتستراد	الساحل
للجليد	الجليد
بسيطه،	بسيطة
منزله	منزل
مساعده	مساعدة
يضع	وضع
صوت…	صوت
بآرد	بارد
القانون؟	القانون
هيأة	هيئة
بسهولة	سهولة
حتي	حتى
حديقه	حديقة
إياه،	إياه
بريي	بري
التفاحة	تفاحة
لرفع	رفع
امتيااز	امتياز
بالبنك	البنك
ماتغسلين	غسل
مجمع	مركز
شدي…	شديد
عصئ	عصا
،حسب	حسب
بااااهر	باهر
رآئحه	رائحة
جدااااا	جدا
سيتم	تم
رفـع	رفع
جريدةالشرق	الشرق
لونها	لون
كل…	كل
اﻷساسية	الرئيسية
فكرةأن	فكرة
إين	أين
قريبًا	قريبا
محابه	محبب
صفر😂	صفر
جزء…	جزء
يحدثُ	يحدث
العصبونات	الضوضاء
فوُق	فوق
مٌباراة	مباراة
الاخضر	الأصفر
كتآب	كتاب
تسجبل	تسجيل
منحه	منح
وعضو	عضو
لقطاعي	قطاع
ثور	بقرة
ومكانهم	مكانكم
هذة	هذه
فقط؟	فقط
المحيط،	المحيط
العين”	العين
أحذَر	حَذارِ
رائي	رأي
خصوصا	خاصة
وقريبا	قريبا
هـب	هبّ
تَحمل	تحمل
ي	يا
البشرة	الجلد
عجلّ	عجل
اللهلئن	لئن
النّار	النار
نجاح…	نجاح
حوالي	حوالى
وإضافة	إضافة
الخلل	خلل
عشب	العشب
قصيير	قصير
الواضح	واضح
التجُربة	التجربة
فِكرة	فكرة
مقدع	مدقع
نتحدث	تحدث
ككذا	كذا
الوقـت	الوقت
علـــــق	علق
نفسه”	نفسه
دخو…	دخول
وورق	ورق
ومكانكم	مكانكم
،وتطالب	مطالبة
باأن	بان
أذا	إذا
الأحد	السبت
هون🌼	هن
ممِا	مما
لہا	لها
بعيدأ	بعيدا
ذو	ذوا
وقفت	وقف
الحزب…	التيار
إيّاي	إياي
مثيررر	مثير
يفوق	تفوق
مروّع	شنيع
آطار	إطار
بعدرحلة	رحلة
حلوووو	حلو
شبة	شبه
عليهآ	عليها
معارك	المعركة
مستوى…	مستوى
أمآ	أما
اسود…	أسود
الابن	الأب
إعادة	اعادة
للطبيب	الطبيب
هؤلا	هؤلاء
هزيلٌ	هزيل
ذاتَ	ذات
حطمت	حطم
رهيب	خرافي
دونك؟	دونك
دقيقٌ	دقيق
طويييل	طويل
انتما	أنتما
الاولى	الثانية
سمعتّ	سمعت
ومنذ	منذ
دولة؟	دولة
ظلَ	ظلّ
أستغرق	استغرق
الإرتفاع	الارتفاع
الرسا…	الرسالة
ااالف	الف
لخارج	خارج
امرأة	سيدة
بسباق	سباق
دوني،	دوني
ضعف،	ضعف
الا	إلّا
مـاء	ماء
وجَه	وجه
وكذلك	كذلك
لعبنا	لعب
قطارات	قطار
•زجاج	زجاج
قادره	قادرة
مسگين	مسكين
غرف	غرفة
ورئيس	رئيس
الازيب	الرياح
احراق	حرق
اللغةالعربية	اللغة
بالتأكيد،	بالتأكيد
بالآحرى	بالأحرى
لمدينة	مدينة
عـوض	عوض
النارجيل	الخشب
أنـاقة	أناقة
إيّاهم	إياهم
حدثَ	حدث
سيئةً	سيئة
بمنْ	بمن
ومخيم	مخيم
الماء	ماء
يوكد	اكد
المدارس	المدرسة
يحقق	تحقق
هواء…	هواء
سنواات	سنوات
بدآية	بداية
جِدار	جدار
ومفتاح	مفتاح
ثمَّة	ثمّة
صحافه	الصحافة
اتسلق	تسلق
ضهر	ظهر
مُضاعفة	مضاعفة
وشقيقة	شقيق
لتطوير	تطوير
مشابه	مماثل
فاااضح	فاضح
أشعارٍ	إشعار
آلجلوس	الجلوس
ركن\/	ركن
علﮮ	على
ونظام	نظام
“أما	أمّا
تفقد	فقدت
لخريطة	خريطة
لقـمة	لقمة
العن	ملعون
ملك…	ملك
مضاعف…	مضاعفة
والرياح	الرياح
كثي…	كثير
كلتآ	كلتا
كُره	كره
لتيار	تيار
👈ولا	ولا
قريب💜	قريب
لاتطلب	تطلب
بشكل…	بشكل
مستعمرات	مستعمرة
أمتداد	امتداد
ﺂمين	آمينَ
إلآ	إلّا
التحصل	الحصول
تذگر	تذكر
و9	و6
عام،	عام
مكانهم	مكانكم
هَذه	هَذِه
ألاّ	ألا
وأم	أم
باقترح	اقترح
،أما	أمّا
وللمزاليج	مزلاج
ميثال	مثال
الصفحـه	الصفحة
تِلك	تلك
النار✨	النار
انتو	أنتم
لكم،	لكم
أياام	ايام
مُقزز	مقرف
هَذَا	هَذا
محاولات	محاولة
،لما	لما
هلاَّ	هلّا
قصِير	قصير
تُريد	تريد
مليو…	مليار
وحمل	حمل
عاامة	عامة
ألحب	الحب
،،وفي	وفي
الجبهههه	الجبهة
صديقه	صديق
خطر…	خطر
الإيجابى	السليم
حلمّ	حلم
مهارت	مهارة
أمسىَ	أمسى
لعلم	علم
عظيّم	عظيم
الإعلام	الصحافة
ذالكم	ذلكم
لعائلة	عائلة
يائس؛	يائس
مسااء	مساء
يتوقع	توقع
وذراعها	الذراع
سلک	سلك
وگانت	وكانت
🌸مع	مع
الفرقة	فرقة
أيضاً	أيضا
بى	بي
والى	الى
،إمّا	إمّا
السّبب	السبب
​طريقة	طريقة
🔴مجلس	مجلس
نتايج	نتيجة
بالتأكيد	بالطبع
،،أما	أمّا
​قبل	قبل
عنصرمن	عنصر
،ان	ان
كنجمة	نجمة
حرب،	حرب
مؤسفٌ	مؤسف
مكانه	مكانكم
ذره	ذرة
طير	طائر
حيء	حي
الأمة،	الأمة
إلا	إلّا
دبي_اليومدراسة	دراسة
تختلفُ	تختلف
الازرق	الأصفر
الاستلقاء	الجلوس
انشودة	قصيدة
تسسجيل	تسجيل
بيكون	يكون
ديگ	ديك
تحّت	تحت
فأن	فان
والحكم	الحكم
كا	ك
كبير…	كبير
دنيئ	دنيء
متتع	ممتع
المواد…	المعادن
لمتجر	متجر
الجلد…	الجلد
حكومة	دولة
هاذا	هذا
•وحده	وحدة
الحديث،	الحديث
مسآعدة	مساعدة
قصير،	قصير
شعر…	شعر
ومجموعة	مجموعة
مُخزٍ	مخز
التربة،	التربة
ذي	ذِي
ممّا	مما
،بعد	بعد
طاقن	طاق
👈ان	ان
ووحشي	متوحش
وكما	كما
عربة	عجلة
وابغض	أبغض
مقعد…	مقعد
بأسم	باسم
كرة…	كرة
فاان	فان
هناااا	هنا
مدرسته	المدرسة
قائلا	وقال
بالوقوف	الوقوف
سعِيدة	سعيدة
الرئيسيّة	الرئيسية
إحسـاس	إحساس
العقوب…	عقوبة
ورتّب	رتب
المعنی	المعنى
الجنية	الجنيه
السيطرة…	السيطرة
أي	أيّ
كآن	كان
ضد…	ضد
خخلف	خلف
التعليم	تعليم
العكس…	العكس
مدقع،	مدقع
والغرامة	غرامة
‏​لما	لما
سيئه	سيئة
يووجع	موجع
مساءا	صباحا
طآلب	طالب
‏السبب	السبب
وقفتو	وقفت
لعمرو	لعمر
رجعت	رجع
هُنَّ	هن
مغناطيسا	مغناطيس
فتااة	فتاة
والذرة	الذرة
قادرهـ	قادرة
طبيعيي	طبيعي
ورمل	رمل
اصقاط	إسقاط
بآهر	باهر
سنووات	سنوات
كثيراً،	كثيرا
بـصوت	بصوت
فسّتانٌ	متأنق
قب…	قبل
هيااااا	هيّا
وأنتم	أنتم
قلبل	قليل
به…	بها
بمنّ	بمن
عندماا	عندما
خطوات	خطوة
وسحب	سحب
إلا…	إلا
الركن	ركن
منحووووس	منحوس
أداةً	أداة
قصّة	قصة
سيطرته	السيطرة
يعطي	أعطى
تحقيق	تحقق
‏هي	هي
بصووت	بصوت
غضب…	غضب
كريييه	كريه
ماده	مادة
لقرية	قرية
سوئ	سوى
يلقي	تلقي
حقيقي…	حقيقي
ألف	الف
بگم	بكم
الكلام”	الكلام
الفكرة	فكرة
لمزيج	مزيج
مهاره	مهارة
لإعادة	اعادة
انتم	أنتن
اختـر	اختر
حبل،	حبل
والجنوب	الجنوب
بيّ	بي
أعلي	أعلى
‏يوم	يوم
أنقلب	انقلب
قامو	قام
عامة،	عامة
ساعةة	ساعة
عواقيبارفق	واهاً
بطيء	بطيئة
حساااس	حساس
إياها	إياهم
حصتها	حصة
خدمه	خدمة
نعم…	نعم
مظلوووم	متفوق
‏بعض	بعض
يحدث	حدث
السفر”	السفر
﴾ربَّ	رُبَّ
الزروع	التربة
رائيس	رئيس
بشرع	شرع
ثلوج	ثلج
انتي	أنتِ
بسوق	سوق
قاعِ	قاع
إياگ	إياك
سوىٰ	سوى
يطـير	يطير
ٺخٺلف	تختلف
سمآوي	سماوي
خطط	خطة
اليكم	إليكم
‼️والمصنع	مصنع
عظيمم	عظيم
بارد…	بارد
بااارع	بارع
مذكرتين	مذكرة
قبعہ	قبعة
،،كم	كم
،حقيقة	حقيقة
رد	الرد
أعطئ	أعطى
نصفُ	نصف
،أنت	أنت
فستااان	فستان
_كل	كل
قكرة	فكرة
المووت	الموت
هذهـ	هذه
لفہ	لفة
ممك	ممكن
أيّ	اي
إختر	اختر
مذکرة	مذكرة
لديهم	لدى
الذي…	الذي
اﻻن	الان
قاموسها	قاموس
تُبدل	تبدّل
لحديقة	حديقة
عضوا	عضو
1لا	لا
العمـر	العمر
مهاراة	مهارة
إلَيْكَ»	إلَيْكَ
اخري	اخرى
لعبت	لعب
معلون	ملعون
الحروب	حرب
رحله	رحلة
الطبيبو	الطبيب
مفاجئة	مفاجأة
،،ياكبر	مابرح
آياه	إياه
كئيييب	كئيب
التسجيل	تسجيل
لاقامة	إقامة
وححده	وحدة
العقوبة	عقوبة
“حين	حين
الأغنية	أغنية
بآن	بان
واقعية	حقيقية
محاسبة	مساواة
بالبحث	البحث
‏اثر	اثر
؛عدد	عدد
متسق	متوافق
برودة	حرارة
كبيير	كبير
‏بحيرة	بحيرة
فقدنا	فقدت
فستبدو	يبدو
وافقت	توافق
مرتفع	منخفض
بكك	بك
نفسة	نفسه
مؤجع	موجع
خاصةً	خاصة
،قاطع	قاطع
لمّا	لما
مكانها	مكانكم
خطيرررر	خطير
أن	ان
رَطبًا	رطب
آمينٌ	آمينَ
آاي	إي
نحِس	نحس
وشركة	شركة
العقوبات	عقوبة
؛الذي	الذي
بقيه	بقية
لذيد	لذيذ
‏وان	وان
قرا	قرأ
ترک	ترك
‏مهما	مهما
المئة	المائة
بمصلحة	مصلحة
وأقول	أقول
ميب	مهيب
ستة	تسعة
الكهرباء	الغاز
الرببع	الربيع
ونأمل	نأمل
ثقلية	ثقيلة
مسالة	مسألة
بااايخ	بايخ
لإثبات	إثبات
آثم	أثم
بقرية	قرية
جععل	جعل
المنزلاللهم	المنزل
بالطابق	الطابق
نافذةُ	نافذة
الثالثة	الاولى
اجابي	إيجابي
اللاتي	اللواتي
positive_emoji0ظهرا	ظهرا
وصار	صار
رهيييب	رهيب
تُعطل	تعتمد
،اذا	اذا
ٱثار	أثار
مطر”	مطر
أنفقَ	أنفق
يلعب	لعب
كاملHD	كامل
مضاعفه	مضاعفة
مخترع	اختراع
لقوى	قوى
خـط	خط
ومحبوب	محبوب
بشريّ	بشري
إقامه	إقامة
‏طفل	طفل
علقّ	علق
بلقاء	لقاء
دَعوة	دعوة
دائره	دائرة
مرغُوب	مرغوب
المحيط…	المحيط
فلانة	فلان
ذلگ	ذلك
سرعااان	سرعان
مبااشر	مباشر
سيارة	شاحنة
وبتالي	وبالتالي
السهبان	هدام
علآمة	علامة
مشترك…	مشترك
عمر	لعمر
مطالبتها	مطالبة
أولائك	أولئك
لقمةِ	لقمة
ومنخفض	منخفض
لرمي	رمي
مهآرة	مهارة
التاهل	الفوز
المباشر	مباشر
مؤسف	مخجل
فعلهم	الفعل
شبهہ	شبه
لتشتعل	اشتعلت
الصمت”	الصمت
هنااااا	هنا
اعلئ	أعلى
طريق…	طريق
كُرب	كرب
دوون	دون
ماراح	راح
شِعر	شعر
نظامها	نظام
ويتحدث	وتحدث
نهااية	نهاية
اصبع	إصبع
شتااء	شتاء
أبقا	أبقى
بسلك	سلك
فيمـا	فيما
شتاءٍ	شتاء
اعلي	أعلى
آب	أب
لفّه	لفة
لكم💕	لكم
سهل،	سهل
السكّر	السكر
الفاصولياء	الفاكهة
سرعتك	السرعة
الخامس	الاول
بشراء	شراء
غرامات	غرامة
الرقم…	الرقم
كُل	كل
وجمال	جمال
وكئيب	كئيب
إليك٠	إليكما
الأمه	الأمة
عرفت	عرف
مسآله	مسألة
مسئلة	مسألة
تسعه	تسعة
قلـب	قلب
حَبل	حبل
اسس	أسس
فآتن	فاتن
‏‏قال	قال
،،كذلك	كذلك
فعل…	فعل
الكلام،	الكلام
متفوقًا	متفوق
خطيير	خطير
ضحية…	ضحية
بآئس	بائس
تكلفة…	التكلفة
فَقدت	فقدت
الدرجة	درجة
تهجير…	تقسيم
بھا	بها
مميز	متميز
مقارنه	مقارنة
سميک	سميك
الرئسية	الرئيسية
فكرةة	فكرة
الصّلب	الصلب
ابدآ	أبدا
إهل	أهل
سمـاء	سماء
ااول	اول
فيمآ	فيما
عاماً	عاما
لطائر	طائر
الاختيار	اختيار
مكرووه	مكروه
عجيييب	عجيب
الحكام	الحكم
ألنظر	النظر
كشراب	غذاء
سحابه	سحابة
لخشب	الخشب
التحكيم	الحكم
قرحٌ	قرح
بِماذا	بماذا
اختلفت	اختلف
بضعة	بضع
لكِم	لكم
وخطر	خطر
مفتآح	مفتاح
الصف،	الصف
ايّام	ايام
مِرح	مرح
قريب💛	قريب
بكَ	بك
وقام	قام
كلّم	كلم
العظام،	العظام
اخذه	أخذ
المشكا	حاشا
سلكه	سلك
التيار	تيار
،هم	هم
أكياس	كيس
تاافه	تافه
نِما	نما
فهوباطل	باطل
وفي…	وفي
ماوقفت	وقفت
ونمط	نمط
‏​أعظم	أعظم
ٺرك	ترك
إختيار	اختيار
تدهب	تذهب
وافحم	واوضح
الحمار	الحيوان
هَذهْ	هَذِه
نسحة	نسخة
كلمآ	كلّما
‏كي	لكي
3عمليات	عملية
أذا	اذا
غبيٌ	ضئيل
؛الذي	الذى
رفـيع	رفيع
مفتوحة؟	مفتوحة
الاجنبيان	اللذان
بكرسي	كرسي
موجع،	موجع
أوراق	ورق
جميل،	جميل
‏إن	إن
تخيلو	تخيل
‏​طفل	طفل
سيئہ	سيئة
،،التي	التي
واحدة	وحدة
اقل	أقل
ماارتفع	ارتفع
بصندوق	صندوق
تافهة	تافه
‏مدينة	مدينة
الطرف	الجانب
دعاوى	دعوى
التزحلق	السباحة
بِك	بك
امراة	امرأة
لشركة	شركة
حرارةالشمس	حرارة
ايسر،	أيسر
الصعبّ	الصعب
هـبّ	هبّ
ألفف	ألف
الملح	ملح
السُكر	السكر
الككلب	الكلب
يرمي	رمي
ثمان	ثمانية
،التي	التي
معاذ،	معاذ
لو	لوما
\/صفر	صفر
الخريف	الربيع
إنّ	إن
شاطر	بارع
قيامها	القيام
إستراحة	استراحة
ۆلم	ولم
المثآلي	المثالي
لطائرة	طائرة
أسمّر	أسمر
حرررر	حر
فالفئة	الفئة
الثاني	الأول
هوا	هو
وحيثما	حيثما
الترقوة	الكتف
لدرئ	دائرة
بالغابات	الغابات
حياه	حياة
أجراس	جرس
حجم…	حجم
مطر؟	مطر
حلوُ	حلو
إثم	أثم
بعملية	عملية
الكـلام	الكلام
وقآلت	وقالت
لإرسال	إرسال
مرتقب	محتمل
مخاطر	خطر
قديييم	قديم
مُحتمل	محتمل
مثالا	مثال
ثمّ	ثم
الشععر	الشعر
خـلق	خلق
،ما	ما
امسس	امس
المفترض	اقترح
هـم	هم
رفيعة	رفيع
حآصل	حاصل
سكر	السكر
الوصف	وصف
اياكم	إياكم
‏منذ	مذ
عبقرى	عبقري
دعمه	دعم
اللّغة	اللغة
وحاشا	حاشا
سئية	سيئة
عملي،	عملي
السبب،	السبب
استثنائي،	استثنائي
فااضح	فاضح
مھما	مهما
يعٺقد	يعتقد
محبووب	محبوب
لعضو	عضو
توفر	توفير
سااعة	ساعة
عـقل	عقل
سعيد…	سعيد
مُخزٍ	مخزي
الولادات	الولادة
يتحول	تحوّل
مث…	مثل
واول	اول
لبيع	بيع
العيّن	العين
إليگم	إليكم
،قبل	قبل
شقيٍ	شقي
ويقول	وقال
شيلة	قصيدة
سيئة،	سيئة
سلبي	إيجابي
متي	متى
بيء	بي
وإهانتهن	إياكن
وجلب	جلب
علامةً	علامة
واااااضح	واضح
نعرف	تعرف
البترول	الغاز
آبيض	أبيض
وراديو	راديو
ساطع،	ساطع
سميكك	سميك
وطالب	طالب
هييييا	هيّا
ايضًا	ايضا
رايع	رائع
🔴جدول	جدول
​فـي	في
”ابن	ابن
الملكية،	الملكية
محبوبة	محبوب
ثمثيل	تمثيل
إياهن	إياهم
صرخہ	صرخة
هَذآ	هَذا
يثبت	إثبات
كمحرك	محرك
فسيحٍ	سحيق
‏ينبغي	ينبغي
بُقعه	بقعة
اﻷرض	الأرض
أسف	آسف
مممتع	ممتع
٠سهل	سهل
غدً	غدا
الزيت	زيت
إنت	أنت
مؤرف	مقرف
الجزي…	الجزيرة
التاريخ،	التاريخ
محاول	محاولة
كٌرة	كرة
بفم	فم
كذالك	كذلك
قريبا…	قريبا
يتطلب	تتطلب
العامل	الطبيب
ايّ	أي
صناعه	صناعة
ثلاثه	ثلاثة
حدثت	حصلت
ثأثير	تأثير
باائس	بائس
مباره	مباراة
آكثر	أكثر
عن،	عن
أقـول	أقول
مايكون	يكون
سيء	رديء
فَأَصْبَحُوا	كَأَنَّ
ميٺ	ميت
حُكم	حكم
بعضهم	البعض
لقمه	لقمة
أسّس	أسس
النطام	النظام
طريقه	طريقة
تتحقق	تحقق
حقيقة…	حقيقة
شركتي	شركة
لكتاب	كتاب
مذكرات	مذكرة
الفوووز	الفوز
العملية	عملية
راااااائع	رائع
سؤالي	السؤال
ٱخر	آخر
نوادردهن	دهن
النتيجه؟	النتيجة
التاريخية	الشهيرة
فحيَّ	حيَّ
الرساله	الرسالة
الأحمر	الأصفر
كِلتا	كلتا
حجر،	حجر
گريم	كريم
اكسجين	الأكسجين
إنجازٌ	منجز
تاااام	تام
《إِنَّ	إِنَّ
السّفر	السفر
بشركة	شركة
معااا	معا
لححن	لحن
لـولا	لولا
زوجه	زوجة
وكالة	لوكالة
إرتفاع	ارتفاع
المازوت	الغاز
يؤكد	اكد
توقف	وقفت
أَيَّتُها	لَيْتَ
حقيقى	حقيقي
گذلك	كذلك
منطقتي	منطقة
خمسة	ستة
الخاصّة	الخاصة
بقر	بقرة
أختلف	اختلف
‏​رجل	رجل
وشامل	شامل
اﻷطفال	الأطفال
شخص،	شخص
شركات	شركة
بوصه	بوصة
`كل	كل
مروِّع	مروع
تعيس”	تعيس
العينكل…	لعين
البيض…	البيض
قوئ	قوى
ذالك	ذلك
يَاأيُّها	لَسْتُنَّ
أخر	آخر
معطفك	معطف
ايّا	أيا
لطرح	طرح
شغل😂	شغل
المال،	المال
الحيوان؟	الحيوان
بطيئه	بطيئة
خاطىء	خاطئ
ملعوووون	ملعون
إنتي	أنتِ
مركز	مكتب
﴿وكأين	كأين
ﺎلليل	الليل
النساء،	النساء
شخصاَ	شخصا
‏​قد	قد
لناا	لنا
گلمة	كلمة
فرفة	فرقة
حالياا	حاليا
أرضٍ	أرض
االليل	الليل
تغييير	تغيير
؛نحن	نحن
باات	بات
اتوقع	اعتقد
رايع	رهيب
“مفهوم	مفهوم
افرزت	جلبت
اَي	إي
كلمَا	كلّما
بسرع…	بسرعة
والجذر	الجذر
احساس	إحساس
العُمر	العمر
استغرقت	استغرق
تتوقف	توقف
،وهو	وهو
لمحرك	محرك
اللواتى	اللاتي
الاصلى	الأصلي
بسيطہ	بسيطة
مُعتاد	معتاد
سواًء	سواء
ﺎلوقوف	الوقوف
آلجبل	الجبل
والفجوة	الفجوة
متفوقه	متفوق
قياده	قيادة
الاعدمات	الحشرة
عمييييق	عميق
بيرجع	رجع
كدبه	كذبة
”لم	لم
حقي…	حقيقة
اقبل	أقبل
إما	إمّا
حيّ	حي
سيما	لاسيما
وطريقة	طريقة
بلاد	بلد
موهبة	مهارة
وشقيقة	شقيقة
راااائع	رائع
التسديدة	القفزة
المئتان	المائة
ترگ	ترك
عدى	عدا
حسٌن	حسن
آلوقت	الوقت
اذ	اذا
،ثم	ثم
الترقوه	الكتف
خدمات	خدمة
وإياك	إياكم
الأن	الان
الغنااء	الغناء
الرقيق،	الرقيق
وقرب	قرب
بالسماح	السماح
إمّـا	إمّا
_بن	بن
ومنجز	منجز
رديء،	رديء
تستغربي	تعجبي
گانت	كانت
يكسى	كسا
حلّ	حل
‏​كيف	كيف
فستآن	فستان
أحتفظي	احتفظ
بأنبوب	أنبوب
ضخم،	ضخم
الفتامينات	المعادن
الموقف	موقف
فكره	فكرة
كورة	كرة
امراه	امرأة
‏أفضل	أفضل
والفئة	الفئة
آي	إي
بالدم	الدم
كررر	كرر
تماماا	تماما
مَلك	ملك
أبيض؟	أبيض
الأمّة	الأمة
عشبها	العشب
بتصميم	تصميم
سقف_زجاج	زجاج
،كان	كان
چيس	كيس
بأسواق	سوق
ورُبَّ	رُبَّ
النااس	الناس
،فان	فان
وايضا	ايضا
نتيجت	نتيجة
حصلة	حصلت
“قلب	قلب
قيمتها	قيمة
للجنائيه	للامم
لعدة	عدة
مليووون	مليون
فرصہ	فرصة
لعبه	لعبة
حركه	الحركة
السلة	القدم
حجمُ	حجم
كاان	كان
حول…	حول
الجمااال	الجمال
كذآ	كذا
دائمًا	دائما
نامل	نأمل
آلصيف	الصيف
جلوسي	الجلوس
فيما…	فيما
حيّن	حين
كيّ	كي
ويجب	يجب
أمام	امام
محتآج	محتاج
وقليل	قليل
ورجل	رجل
خللٌ	خلل
خراافي	خرافي
غريبٍ	غريب
ركض🏃	ركض
‏​عند	عند
اللتي	التي
💕سبحان	سبحان
من2غرفة	غرفة
إجابي	إيجابي
سحبب	سحب
لمصلحة	مصلحة
سميِك	سميك
عايلة	عائلة
الموت،	الموت
وأن	وان
سساعة	ساعة
لطيفة	لينة
آمامك	أمامكَ
ماء،	ماء
خالقيكتلة	كتلة
حك	فرك
التغييرية	الملكية
ورتب	رتب
لايمكن	يمكن
الإلتهابات	الجلد
فرقتين	فرقة
النافذة	نافذة
بـشكل	بشكل
القدم⚽️	القدم
اللتان	اللتين
جمال…	جمال
ومازال	مازال
علبه	علبة
مريضٍ	مريض
منطقة…	منطقة
يقرا	قرأ
لمجموعة	مجموعة
الحارّة	الحارة
تمّر	تمر
رءيس	رئيس
الزامهم	السماح
؛أن	أن
حِين	حين
سِكة	سكة
حُلو	حلو
ومتقن	متقن
وديي	ودي
آخر…	آخر
إسقا…	إسقاط
عصآ	عصا
عييب	عيب
انما	إنّما
ااحد	احد
خمسة	تسعة
اسف	آسف
خللًا	خلل
انبوب	أنبوب
مگتب	مكتب
فقيرٍ	فقير
سُمح	سمح
لديها	لديه
الرئيسيه	الرئيسية
ورفيع	رفيع
يغادرون	غادر
نادمھ	نادم
أكد	اكد
عخط	خط
إظهار	إثبات
هَـذِه	هَذِه
نهآية	نهاية
خمسه	خمسة
إذنْ	إذن
الاب	الأم
‏أعظم	أعظم
بغسيل	غسل
تبدّليآ	تبدّل
مفاجأه	مفاجأة
المنبطحين😄	الحيوان
وأنّى	أنّى
القطاع	قطاع
حقيقة”	حقيقة
المنزل🌹	المنزل
\/شقيق	شقيق
سوى…	سوى
ليها	لها
عملي…	عملي
والسفر	السفر
حيّث	حيث
وحتى	حتى
لﻷمم	للامم
حلَبْ	مَنْ
قدموا	قدم
باحات	ساحة
بموجة	موجة
ضئيلة	ضئيل
يائسّ	يائس
لايزال	مازال
الفِعل	الفعل
مساواتنا	مساواة
ايضآ	أيضا
احد…	احد
بإن	بان
✨تم	تم
طالمآ	طالما
بسيطةة	بسيطة
مدين…	مدينة
فگرة	فكرة
طوُل	طول
،طيب	طيب
مُحزن	مؤسف
لاتناسب	تناسب
شعـر	شعر
✋هو	هو
نهاىي	نهائي
تافِه	تافه
اه	آه
يطيـر	يطير
“حكم	حكم
لأجل	اجل
اياها…	إياهن
حسَي	حسي
والمال	المال
رِحلة	رحلة
حذآء	حذاء
آثنين	اثنين
الحٌب	الحب
وصولهم	الوصول
بقيّة	بقية
مخُتار	مختار
كتبه	كتب
شغغغل	شغل
نومم	نوم
جزءً	جزء
تحتـاج	تحتاج
ندمان	نادم
نفسّ	نفس
طبيب	الطبيب
صيحات	صيحة
مُستوى	مستوى
لما	لمّا
،أعظم	أعظم
وتدفق	تدفق
بالمعرض	المعرض
كرهہ	كره
حَرف	حرف
مفتا…	مفتاح
خللا	خلل
ومثلث	مثلث
الحليب	الخبز
أمينَ	آمينَ
هذِه	هَذِه
لزيارة	زيارة
عليه💕	عليه
جنآح	جناح
،مقارنة	مقارنة
وظع	وضع
​مقطع	مقطع
؛مَنْ	مَنْ
بسُرعة	بسرعة
العاصمة…	العاصمة
،ولم	ولم
ماعاد	عاد
قصةة	قصة
مادتي	مادة
مكتوبةٍ	مكتوبة
خيآلي	خيالي
«سبحان	سبحان
الأصفر	الأخضر
مائةَ	مائة
ظلِ	ظلّ
عاى	على
نفسه،	نفسه
فجرا	ظهرا
وكاان	وكان
كدبة	كذبة
اﻷبتسامة	الابتسامة
المخاط	البخار
الثلج	الجليد
هنحس	نحس
فقيروفرج	مكروب
وبماذا	بماذا
مكتوبه	مكتوبة
واستنجدك	رويدك
البيض،	البيض
تجربه	تجربة
سادسا	رابعا
‏مثل	مثل
وهواء	هواء
مره	مرة
مُخزي	مخجل
مكانك	مكانكم
ستضمن	تضمن
المطالبة	مطالبة
لدئ	لدى
اربعه	اربعة
ااي	إي
تركض	ركض
لطيف،	لطيف
الكلب…	الكلب
ترفض	توافق
،التي	التى
👇هيا	هيا
وتصميم	تصميم
،مائة	مائة
الجوبه	الوادي
جدولي	الجدول
عقلٌ	عقل
حلو😂😂	حلو
والسبب	بسبب
لإعداد	إعداد
‏شاهد	شاهد
،سقط	سقط
المُوت	الموت
مساءاً	صباحا
بقترح	اقترح
حجمَ	حجم
كُرسي	كرسي
وأجمع	أجمع
السلع…	المعادن
خاصه	خاصة
خزب	حزب
بطيئة،	بطيئة
وهيئة	هيئة
إذًا	إذن
جدولكم	الجدول
الذی	الذى
فخخخم	فخم
عقوبه	عقوبة
،،ومن	ومن
آلبحث	البحث
لَطيف	لطيف
مگتوبة	مكتوبة
غالباَ	غالبا
أنتوا	أنتم
اسم	إسم
أحرق	حرق
سيارة…	سيارة
تحتَ	تحت
غنيّ	غني
لسْتُ	لَسْتُ
‏‏أعظم	أعظم
مُساعدة	مساعدة
✨مع	مع
للمالوالسائل	السائل
عميق،	عميق
ممييز	متميز
﴿إِنَّ	إِنَّ
الحاض…	الحاضر
دراسات	دراسة
منهاا	منها
جمعية	مركز
عدمم	عدم
الحركه	الحركة
اصولية	لاحقة
لتغيير	تغيير
وحفظ	حفظ
الجدول	جدول
الذين…	الذين
هاهُنا	هاهنا
متأخّر	متأخر
حراراة	حرارة
إقول	أقول
احسااس	إحساس
مطـر	مطر
ومنعطف	منعطف
زياره	زيارة
بإل	بال
لذين	اللذين
لكمآ	لكما
تلكـ	تلك
فخمم	فخم
لشقيقة	شقيقة
كلمه	كلمة
الرابع	الاول
ووقفت	وقفت
النھر	النهر
مينائي	ميناء
قول…	قول
بورقة	ورقة
نضيف	نظيف
وحجر	حجر
الصمت…	الصمت
سبحانكتعلم	تعلم
المسار	مسار
شكل…	شكل
ألرجال	الرجال
بمحاولة	محاولة
أستمع	استمع
منعول	ملعون
مطر💙	مطر
سعبد	سعيد
حلووو	حلو
مؤلمَ	مؤلم
خلـق	خلق
جعله	جعل
بكتاب	كتاب
لمنعشها	اللتيا
كأنما	كأنّما
صبااح	صباح
راااح	راح
واختلف	اختلف
غنّي	غني
العّين	العين
مثلما	كما
الطيبة_	الرقيق
متا	متى
عموود	عمود
قالت	وقالت
نافذةً	نافذة
ضمن…	ضمن
حنجرة	صرخة
يااا	يا
بشك…	بشكل
الصعب…	الصعب
مفہوم	مفهوم
لحطة	لحظة
أنفققال	أنفق
الصمت،	الصمت
قطعہ	قطعة
الربيع؟	الربيع
جلبوا	جلبت
نفسہ	نفسه
`ما	ما
‏متى	متى
أجل…	أجل
مُعين	معين
عائله	عائلة
فكـرة	فكرة
اعطى	أعطى
التجرية	التجربة
مرّوع	شنيع
ععين	عين
بشريط	شريط
اتجاه	تجاه
حيات	حياة
عييييب	عيب
أبدًا	أبدا
الجزيره	الجزيرة
حالة…	حالة
خوف،	خوف
آلات	آلة
الأول	الاول
حراره	حرارة
هگذا	هكذا
الحاضرُ	الحاضر
الذهَب	الذهب
بلا	بلى
والصلب	الصلب
،بين	بين
حديد…	حديد
لگي	لكي
نھاية	نهاية
أذن	إذن
🔴وصول	وصول
قطاعات	قطاع
كاملة…	كاملة
النظان	النظام
للطاقة	الطاقة
قااااع	قاع
لـمس	لمس
خـوف	خوف
ذهنى	ذهني
عناصر	عنصر
لمست	لمس
يطلب	تطلب
نتيجة…	نتيجة
الأفعال	الفعل
شيء♥	شيء
عامًا	عاما
لمخيم	مخيم
آختبار	اختبار
ذراعهم	الذراع
،،ثم	ثم
الحقيقي	الأصلي
كى	كي
الاّ	الا
وتابع	تابع
فكلاهما	كلاهما
آقل	أقل
قواميسهم	قاموس
الموسمو	الموسم
حفرية	حفرة
لععب	لعب
سلگ	سلك
يومأقبل	أقبل
أكدت	اكد
وعمر	لعمر
مشكله	مشكلة
الحزب	التيار
الْعِلْمُ	نِعْمَ
الصباااح	الصباح
ااي	آي
يظهر	تظهر
تجاره	تجارة
كبذرة	بذرة
عجاب،	عجب
واستحال	استحال
والشاطئ	المحيط
الغنآء	الغناء
رابانجذاب	جذاب
إليْكْ	إلَيْكَ
مساااء	مساء
والتى	التى
ذهـب	ذهب
واياكم	إياكم
يككون	يكون
فساتين	فستان
لقائي	لقاء
جندى	جندي
​مِن	مِن
الثالث	الاول
قواميس	قاموس
،عدد	عدد
بغسل	غسل
عشره	عشرة
راي	رأي
الابتسامه	الابتسامة
وأضح	واضح
‏لستَ	لَسْتُ
تمممم	تم
عظييييم	عظيم
الشروقوى	قوى
عليكك	عليك
الثالثه	الاولى
تاااافه	تافه
‏جدول	جدول
فيه❤	فيه
تُظهر	تظهر
الموضوغ	الموضوع
منفقير	فقير
لاكن	لكن
وبالتالى	وبالتالي
مزيجٌ	مزيج
رميات	رمية
مضارب،	مرؤوس
|سجل	سجل
كريم؟	كريم
الموضوع	موضوع
ففط	فقط
بمنطقة	منطقة
شكله	شكل
متاحة	جاهزة
ليِتَ	لَيْتَ
اسمع	استمع
وآحد	واحد
لاغنية	أغنية
نِعْم	نِعْمَ
الدّم	الدم
هكذ	هكذا
اسبوعين	أسبوع
قلييل	قليل
شبهه	شبه
ااكثر	اكثر
االذين	اللذين
شديده	شديد
🌹الذي	الذي
ممارس…	ممارسة
الجزيرة…	الجزيرة
ثلجج	ثلج
الملكيّة	الملكية
آينما	حيثما
ممَّن	ممن
بيدِ	بيد
دخوله	دخول
الإساسية	الأساسية
قط؛	قطّ
اثم	أثم
،كم	كم
طريقہ	طريقة
بعيد؟	بعيد
الخاصه؟	الخاصة
واحد😂	واحد
_هما	هما
إنبنا	نما
متوقع	محتمل
ايسر	أيسر
شتا	شتاء
أسوود	أسود
انطر	انتظر
الأرض،،	الأرض
خيير	خير
كيس…	كيس
گيس	كيس
حرارت	حرارة
بجدول	جدول
وظريف	ظريف
أخد	أخذ
قااعدة	قاعدة
بتحسين	تحسين
بتدفق	تدفق
واان	وان
‏الأم	الأم
عليه✋	عليه
ويحكَ	رويدك
يبنغي	ينبغي
فقط…	فقط
مشلكة	مشكلة
المباراة	مباراة
ولا…	ولا
بالحصول	الحصول
حبال	حبل
بفوز	فوز
خيرر	خير
نظييف	نظيف
حمّل	حمل
أحتفظ	احتفظ
رٌبما	ربما
مهمآ	مهما
اوقف	وقفت
العمل؟	العمل
بمحرك	محرك
الآ	الا
بحرٌ	بحر
؟ماذا	ماذا
رويدكَ	رويدك
باطل…	باطل
طويل،	طويل
استلزم	استحال
مـزلاج	مزلاج
‏لو	لو
فيمَا	فيما
الوقوف…	الوقوف
انتشار…	انتشار
الرجاال	الرجال
لجدول	جدول
ااسم	إسم
اليوم…	اليوم
شارع…	شارع
واه	آه
🔴خطاب	خطاب
​ممكن	ممكن
لمزرعه	مزرعة
شخصًا	شخصا
لّما	لمّا
الفعل…	الفعل
كثيييير	كثير
بإسم	باسم
برصد	رصد
تكرر	كرر
جآف	جاف
بتعتمد	تعتمد
حصولك	الحصول
مشغولة	مشغول
اﻷصلي	الأصلي
رهييب	رهيب
بمآ	بما
لمذكرة	مذكرة
صفرر	صفر
الوحيدالذى	الذى
الذره	الذرة
لخط	خط
إمتياز	امتياز
الفَرح	الفرح
الليّل	الليل
♥هي	هي
قاام	قام
ماذآ	ماذا
خآئف	خائف
حلييب	حليب
ظريف،	ظريف
كرهه	كره
مضاعفة،	مضاعفة
نحييف	وسيم
مُفتاح	مفتاح
الفئه	الفئة
حِذاء	حذاء
متناسب	متوافق
حميع	جميع
النضام	النظام
أبٌ	أب
كتيب	كتاب
جولات	جولة
طفلٍ	طفل
ومحاولة	محاولة
أستراحة	استراحة
سيحطم	حطم
اﻻول	الأول
؛وقد	وقد
يرفع	رفع
إليگَ	إليكَ
مؤلممم	مؤلم
مُضاعفه	مضاعفة
خطوھ	خطوة
؛مهما	مهما
لهيئة	هيئة
بلىٰ	بلى
للكتف	الكتف
كايت	كيت
،الا	الا
ظلَّ	ظلّ
اسفه	أسف
برحلة	رحلة
مووضوع	موضوع
عيب،	عيب
ﺎرتفع	ارتفع
مشاكل	مشكلة
قادرةعلى	قادرة
علييل	عليل
بالعاصمة	العاصمة
‏إياك	إياك
دۈن	دون
بلد؟	بلد
نص	نصف
وتوقف	توقف
قَبْرَا	لَسْتُ
تفاحهہ	تفاحة
كثيرا”	كثيرا
ورمز	رمز
حاصل…	حاصل
اديرع	الوادي
لطريق	طريق
أغنيه	أغنية
تهما	تهمة
العِظام	العظام
وقتل	قتل
تفاحه	تفاحة
الموت…	الموت
صغييير	صغير
‏نحن	نحن
إيّاه	إياه
كبيرر	كبير
تامّ	تام
إيآك	إياك
جدارا	جدار
بسطح	سطح
انهيار	انزلاق
أستثنائي	استثنائي
مستواء	مستوى
“إذا	إذا
زهور	زهرة
مُمارسة	ممارسة
بطرالحق	الحق
المعرك…	المعركة
قوي،	قوي
خير♡	خير
بأنه	انه
السباحة،	السباحة
قرر	تقرر
لدي	لدى
،او	او
لعدم	عدم
اسمها	اسم
تحدثُ	تحدث
أبداً	أبدا
فظيييع	فظيع
متجري	متجر
الحاضر…	الحاضر
ايدي	يد
،،مادام	مادام
المعادن،	المعادن
لحّن	لحن
مِمّا	مما
تسجيلهم	تسجيل
مايطير	يطير
إمراة	امرأة
بك❤️	بك
آلمترفين	مترف
الكستناء	الذرة
تعرِف	تعرف
ذل…	ذلك
إستخدام	استخدام
اينماا	أينما
صوووت	صوت
نوووع	نوع
الفخذ	الساق
قااع	قاع
بہا	بها
لطيفٌ	لطيف
،باب	باب
بااااااطل	باطل
قلمآ	قلما
يَبدو	يبدو
أكثر…	أكثر
مسكيييين	مسكين
مھيِن	مهين
بعيدًا	بعيدا
الفووز	الفوز
سووق	سوق
الأمة…	الأمة
وغرفة	غرفة
ۈلم	ولم
تمثيل،	تمثيل
اوول	اول
عمليت	عملية
النجمة	نجمة
والطرفان	اللتان
،أما	اما
نهائيي	نهائي
تحتاج	تتطلب
معاا	معا
زياردة	زيارة
والحاظر	الحاضر
إليك_كتابي	كتاب
كبيييير	كبير
الركبتين	الرقبة
الشبا…	الشباب
أربعة	سبعة
بقيّةْ	بقية
اﻷم	الأم
التواصل	تواصل
ﺎلبعض	البعض
خايس	بايخ
هناكك	هناك
لاينبغي	ينبغي
؟هل	هل
الصّمت	الصمت
مسيكين	مسكين
تحتوى	تحتوي
كآلة	آلة
ینبغي	ينبغي
وقح	منحط
سَعيدة	سعيدة
❤ومن	ومن
سلبى	سلبي
فضاء	الفضاء
جداً…	جدا
،قليل	قليل
ميبس	منشار
توافقان	توافق
_لم	لم
اليم	أليم
وبدلاً	بدلا
الايدلوجيات	الضوضاء
التلطيفية	الرعاية
مجند	جندي
اصبح	صار
بدآيه	بداية
الكـل	الكل
​حكم	حكم
عليه♡	عليه
رأيي	رأي
ملكات	ملكة
حبث	حيث
ماكانت	وكانت
صباحاا	صباحا
ابقى	أبقى
الثلاثاء	السبت
الناااس	الناس
نآدم	نادم
القارّة	القارة
مقاب…	مقابل
وصفر	صفر
غِطاء	غطاء
لاٌٍﮯ	لا
نُوع	نوع
عقل؟	عقل
وقفوا	وقف
بعيييد	بعيد
خايف	خائف
بعـض	بعض
الضـرورة	الضرورة
وهيَ	وهي
الوﻻده	الولادة
الأتجاه	المسار
؛قد	قد
حصل	حاصل
الغني	غني
وخلايا	خلية
للتيار	التيار
ينقلب	انقلب
رجعوا	رجع
وصع	وضع
ذرّة	ذرة
باب…	باب
لمكان	مكان
مكروه…	مكروه
وتنمو	تنمو
كيفماا	كيفما
هآدئ	هادئ
عجلتي	عجلة
التى	التي
بتختلف	تختلف
،لماذا	لماذا
وتيار	تيار
ممگن	ممكن
مكتئبه	مكتئب
أخرى	اخرى
تخيييل	تخيل
واسود	أسود
تلكَ	تلك
طويييييل	طويل
تذهبُ	تذهب
تمّ	تم
سبب	السبب
يوقف	توقف
حاليا	الان
منبحث	بحث
ألة	آلة
الفضآء	الفضاء
قريب،	قريب
يقطع	قطع
الخلابة	الطبيعة
وعلم	علم
النفـس	النفس
حرّى	حرى
،كتب	كتب
عظيم💙	عظيم
دون…	دون
فكلا	كلا
بذور	بذرة
قآطع	قاطع
وحسب	حسب
بقاموس	قاموس
،،،،ولا	ولا
السفينة	سفينة
رُبَّ	رُبَّ
سُرعان	سرعان
آى	آي
الذى	الذي
به💛	به
التصديقات	الرعاية
لمزرعة	مزرعة
وهل	هل
للملشيات	للامم
بدائرة	دائرة
سباقات	سباق
مأئة	المائة
عمليات	عملية
صديقٌ	صديق
7عناصر	عنصر
الخاصه…	الخاصة
والسماح	السماح
وجهہ	وجه
منجرة	منجم
‏​لو	لو
بقعةً	بقعة
الطبيعة،	الطبيعة
لاتحدث	تحدث
دۈني	دوني
كربَ	كرب
هبَ	هبّ
لّما	لما
سواءا	سواء
إنها	انها
عدم…	عدم
يـد	يد
نحسّ	نحس
السّائل	السائل
مزرعـة	مزرعة
تحوي	تحتوي
وفرقة	فرقة
وبذيئ	بذيء
بمآا	بما
غسيل…	غسل
ببطاقة	بطاقة
الصحف	الصحافة
بتعليم	تعليم
«خلية	خلية
هوأسفل	أسفل
أطفال	الأطفال
اللآتي	اللائي
مُتأسف	متأسف
__ما	ما
يقدم	قدم
أياها	إياها
فالمال	المال
المساوات	مساواة
الدم؟	الدم
صاير	صار
كمية	كتلة
غالبآ	غالبا
‏كم	كم
تناسبُ	تناسب
قبضه↩صاعق	صاعق
تلقآء	تلقاء
مييييت	ميت
‏عدم	عدم
بدايه	بداية
تتطلّب	تتطلب
ارسال	إرسال
رقمنا	الرقم
بشري…	بشري
الضرب	ضرب
سؤال	السؤال
فريسة	ضحية
كـم	كم
نمشيِ	قديم
وهناك	هناك
فيه،	فيه
الجمال…	الجمال
القدمّ	القدم
مششغول	مشغول
‏حديقة	حديقة
سنة…	سنة
مصنع	منجم
بساحة	ساحة
بمآذآ	بماذا
ممَّا	مما
‏وحده	وحدة
موضوغ	موضوع
متقنها	متفوق
ألذين	الذين
يأخذ	أخذ
مضاعفۃ	مضاعفة
والدولار	الدولار
مرفوض…	مرفوض
شقه	شقة
فروع	فرع
؛؛لا	لا
يوقف	وقف
آرسلت	أرسلت
قريبب	قريب
“قلبّك	كلَّا
كبيررر	كبير
⁰بل	بل
‏سبحان	سبحان
سمعنا	سمع
اأقل	أقل
،ثم	ثمّ
ميزه	ميزة
واسم	اسم
اللليل	الليل
مساله	مسألة
‏خريطة	خريطة
وفن	فن
بِأَنَّ	أَنَّ
نطام	نظام
ولتلبية	تلبية
و5	و6
بالأصح	بالأحرى
تآلق	تألق
أقامة	إقامة
الطاقة؟	الطاقة
مطالبتهم	مطالبة
الأ	الا
المعرفة	التجربة
ذهب،	ذهب
زائل،	زائف
خلاا	خلا
الضحكك	الضحك
ياائس	يائس
توجية	توجيه
فُرصة	فرصة
وتحسين	تحسين
وخطاب	خطاب
دعمنا	دعم
صرخةة	صرخة
الكثير	القليل
مخيمات	مخيم
وآسع	واسع
فِ	ف
لسيد	سيد
ثاني	ثان
‏مَنْ	مَنْ
ذرةة	ذرة
يطيّر	يطير
الشّعر	الشعر
شخـص	شخص
آجل	أجل
بصحراء	صحراء
رآقي	راقي
الحديث…	الحديث
ارتفاع…	ارتفاع
،مهما	مهما
وتر،	وتر
قيمةة	قيمة
أيسر،	أيسر
أككل	أكل
حلبات	سباق
جاناتا	مافتئ
اليككك	إليكما
هنااا	هنا
ﺎلجمال	الجمال
وهاتين	اللتين
يُعقد	عقدت
جيث	حيث
ايقاف	توقف
رغبوا	رغب
الجزيزة	الجزيرة
المدين…	المدينة
الصيف،	الصيف
مضاعفة♡	مضاعفة
الا	إلا
جلييل	جليل
﴿وقال	وقال
،لن	لن
ايذا	اذا
اهل	أهل
طفلاً	طفل
الأزرق	الأخضر
العاصمه	العاصمة
امامك	أمامك
المقتولان	اللذان
النتجية	النتيجة
هنّ	هن
حجمم	حجم
الرئيسية؟	الرئيسية
مايحدث	حدث
أليم…	أليم
فحالة	حالة
النفسّ	النفس
بتهمه	تهمة
عليل	سقيم
عاما…	عاما
باررد	بارد
فحصة	حصة
الاسبق	السابق
سهولـة	سهولة
وسرعان	سرعان
‏لحظة	لحظة
وعنصر	عنصر
التام	تام
‏طبيعة	الطبيعة
نجمه	نجمة
بيد…	بيد
لعينا	لعين
آما	اما
مطاردت	مطاردة
اختار	اختر
وشارع	شارع
هيا	هيّا
فوقَ	فوق
شاحنه	شاحنة
،كاد	كاد
حماية…	حماية
افتقدت	فقدت
‏أكثر	أكثر
تعلن	اعلنت
درجات	درجة
ولعب	لعب
بالطبع	بالتأكيد
الذينَ	اللذين
اتصا…	اتصال
مِلح	ملح
||عقد	عقد
حبـل	حبل
بنوع	نوع
فاٺن	فاتن
جلوسهم	الجلوس
ثآني	ثان
تلكك	تلك
الأسنان…	الأنف
رجُل	رجل
التجلطات	الضوضاء
سَهل	سهل
حل،	حل
عاد؟	عاد
قديم؟	قديم
،وقد	وقد
سُرعانَ	سرعان
بحزب	حزب
خطييييير	خطير
بااال	بال
اذًا	إذاً
توقفت	توقف
مريب	مخزي
عين	لعين
ايضًا	أيضا
٠صحيح	صحيح
الربيع…	الربيع
سقيـم	سقيم
رااااائع	رائع
كامل❤️	كامل
البوارح	الرياح
“لستُ	لَسْتُ
المموت	الموت
كثيير	كثير
مجبوب	محبوب
منها💜	منها
فلاان	فلان
حبيبتي	عزيزتي
لشريط	شريط
،،تم	تم
بـاب	باب
لطفل	طفل
كسوق	سوق
لكم🌷	لكما
ياسيد	سيد
صنوق	صندوق
وغطاء	غطاء
ككره	كره
شمش	شمس
مُدهش	مدهش
وسكة	سكة
يحصل	حاصل
متكامل	شامل
الثانيه	الثانية
طوويل	طويل
كقتل	قتل
تدفقات	تدفق
​​قد	قد
لاتظهر	تظهر
أربع	اربعة
أميرة	ملكة
‏كلما	كلّما
دبي_اليوماكتشاف	اكتشاف
نهايه	نهاية
وإياك	إياك
مقصود،	مقصود
اﻻولى	الاولى
خاطء	خاطئ
أقول؛	أقول
بلون	لون
الكث…	الكثير
يعرف	عرف
منه	منها
ماهيب	مهيب
القدم،	القدم
مصفاة	محطة
‏مادام	مادام
للعبة	لعبة
قطُّ	قطّ
مُفزع	مفزع
الوق…	الوقت
رهيب	عجيب
تشيرالى	تشير
الريف	الساحل
أستمعوا	استمع
♥ان	ان
هكذاا	هكذا
السادسة	الثانية
لي💓	لي
جذاب،	جذاب
العالم…	العالم
الصحية…	الأساسية
معركتهم	المعركة
الشريط	شريط
قطعةً	قطعة
البازلت	الجليد
ششكل	شكل
وذيل	ذيل
يحتاج	تحتاج
ضريف	ظريف
اللائي	اللاتي
عجيب	غريب
3بطاقات	بطاقة
صبـاح	صباح
بدولة	دولة
بتعرف	تعرف
وضيييع	وضيع
أختراع	اختراع
،عرف	عرف
لسلك	سلك
ونهائي	نهائي
غدا…	غدا
احساسي	حسي
عضوء	عضو
الاعداء	العدو
موسيقى	الموسيقى
اللذى	الذى
دعوه	دعوة
السيطرةعلى	السيطرة
بارع،	بارع
بشهر	شهر
‏يبدو	يبدو
منحديد	حديد
عمليوبيتي	عملي
حيثمآ	حيثما
تلك	تلكم
اربع	سبعة
بلحن	لحن
جديدة،	جديدة
رجعكم	رجع
وإعداد	إعداد
تِلقاء	تلقاء
ياخذ	أخذ
الخير	الألاء
💋❤رقص	رقص
الجبها	الجبهة
مليون…	مليار
ومشترك	مشترك
مُحبب	محبب
دآئرة	دائرة
فالإنتقال	الوصول
الجميع	الكل
،تحدث	تحدث
مواد	مادة
أمامه	أمامك
بال،	بال
سلسلةمن	سلسلة
لطيّف	لطيف
عَرف	عرف
أتوقع	اعتقد
يستخدم	استخدام
إليكِ	إليكَ
تدفع	دفع
،ألا	ألا
‏أول	اول
بعيد،	بعيد
الشب…	الشباب
وحييد	وحيد
لزوجة	زوجة
الازدية	الصلب
،سبحان	سبحان
وسط…	وسط
ايااام	ايام
مقارنةً	مقارنة
أمام…	امام
كَانَ…	سَاءَ
‏طائر	طائر
نتاجا	امتداد
خوف،،	خوف
مٺرف	مترف
انطلياس	الشراع
لوﻻ	لولا
لديهَ	لديه
هلَّا	هلّا
آحسآس	إحساس
فيها…	فيها
الحااره	الحارة
لنآ	لنا
راقبَ	راقب
أفض…	أفضل
نحسسها	نحس
لكم💕	لكما
هنا👈🏼…	هنا
صغيررر	صغير
تأثير…	تأثير
سعيده،	سعيدة
حيـاة	حياة
وزني	الوزن
تلقى	تلقي
الصيف…	الصيف
كثير،	كثير
مباشرةً	مباشرة
مصفاة	ميناء
قريب…	قريب
نغمه	نغمة
حقيفة	حقيقة
ولادتهن	الولادة
عظيم💙💙	عظيم
روائح	رائحة
هواءالنفس	هواء
الصفوف…	الصف
النسخة	نسخة
ايجابي	إيجابي
متاخره	متأخر
خمسون	عشرون
رصاصي	رمادي
بيدالله	بيد
الجلل،	جلل
البنك…	البنك
إذنـ	إذن
المصطلح	مصطلح
حرف،	حرف
صُور	صور
ممل	مقرف
••سبحان	سبحان
احد”	احد
فبل	قبل
النتائج	النتيجة
عصاً	عصا
اصفر	أحمر
اميرة	ملكة
حَجم	حجم
تجربة…	تجربة
التصاعد	الارتفاع
وبقعة	بقعة
ﺎلف	الف
أرادوا	أراد
بتجارة	تجارة
التوارث	الجمع
أبداً،	أبدا
لديه	لدينا
ماجوسي	نجس
اﻷب	الأب
حلول	حل
التأهل	الفوز
منها،	منها
هذهِ	هذه
‏أم	أم
نافذتي	نافذة
تعليم…	تعليم
انو	انه
بحرب	حرب
الرجال…	الرجال
مضلم	مظلم
القلييل	القليل
الفصل	القسم
االرد	الرد
اليوم،	اليوم
رقمه	الرقم
إم	أم
قذائف	قذيفة
فرة	لفة
ناادر	نادر
منخفص	منخفض
ومصنوعة	مصنوع
وهوا	وهو
حقييقي	حقيقي
كمثال	مثال
بحدث	حدث
سبوع	أسبوع
الإناث	النساء
ألموت	الموت
‏عدد	عدد
فترة…	فترة
الجيرآن	الجيران
النار❤❤	النار
حفرةمن	حفرة
الصُلب	الصلب
گبير	كبير
ولكي	لكي
الأول	الثاني
الفواكه	الفاكهة
وانتظر	انتظر
عددة	عدة
اب	أب
حقيقهه	حقيقة
كبير”	كبير
وبحسب	حسب
هُناك	هنالك
ٺحمل	تحمل
حيثما	أينما
ومقارنة	مقارنة
آيّ	آي
منفصله	منفصلة
تفس	نفس
اﻻصلي	الأصلي
الدكتور	الطبيب
الاساسية	الأساسية
منزل،	منزل
طوال	طول
كّ	ك
كهرباء	كهربائي
بدونك	دونك
المتوافقه	متوافق
سلسة	سلسلة
إيجابي	سلبي
إجمع	أجمع
نحو…	نحو
بدء	بدأ
قذيقة	قذيفة
حافہ	حافة
لَسْت	لَسْتُ
عسي	عسى
الخطة	خطة
بزيت	زيت
🔴استمع	استمع
سيحدث	يحدث
اسنان	أسنان
دايما	دائما
مارتفع	ارتفع
مشغوله	مشغول
الناس💜	الناس
لعنصر	عنصر
حفط	حفظ
هتعلن	اعلنت
طالبه	طالب
،،هو	هو
طيّب	طيب
اسمه	اسم
قذيفتي	قذيفة
الرّد	الرد
مقعدين	مقعد
رئيسيا	رئيسي
احتفظي	احتفظ
ظل	ظلّ
ومفهوم	مفهوم
الحب،	الحب
آخذ	أخذ
القادمة	الاخيرة
‏إذا	إذا
قريب	قريبا
مظلم…	مظلم
الكثير،	الكثير
هنااك	هناك
رمزآ	رمز
قبادة	قيادة
لكرسي	كرسي
نجمع	جمع
العمُر	العمر
تٌلقي	تلقي
‏قريباً	قريبا
يعنقد	يعتقد
مطالب	مطالبة
منها”	منها
هب	هبّ
مكروب،	مكروب
لسِتُ	لَسْتُ
لقاء…	لقاء
السابع	الثالث
وااااسع	واسع
بخط	خط
ماجاء	جاء
هناک	هنالك
ينغي	ينبغي
ومركز	مركز
بنـا	بنا
وجاهزة	جاهزة
تحسيين	تحسين
خليّة	خلية
نجاحها	نجاح
خرااافي	خرافي
لحماية	حماية
أدوات	أداة
بصوووت	بصوت
آعظم	أعظم
،الذي	الذي
شرعة	شرع
لولاا	لولا
إنمآ	إنّما
العُشب	العشب
يكو…	يكون
جَمال	جمال
العالمم	العالم
العظا…	العظام
وف	وفي
بحسب	حسب
إليكَ…	إليكَ
آلماضي	الماضي
بالأحرىلا	بالأحرى
وخوف	خوف
وقريب	قريب
باااااايخ	بايخ
كامله	كاملة
الإبن	الأب
سياره	سيارة
كيَ	كي
حقيق…	حقيقة
بككم	بكم
فقدتُ	فقدت
إياه…	إياهم
بزرنة	ظرافة
قياس؟	قياس
قادرهه	قادرة
كيذا	كذا
مباشرة…	مباشرة
عام…	عام
مصنوعه	مصنوع
دقيقه،	دقيقة
إلغاء	إقامة
التي	التى
لساحة	ساحة
فاتنّ	فاتن
زجآج	زجاج
يختلف	اختلف
المعادنفإذالم	المعادن
اسقاط	إسقاط
وعدم	عدم
‏كيف	كيف
نسخةً	نسخة
إنَّما	إنّما
لاستخدام	استخدام
؛ولم	ولم
ساحةة	ساحة
وهكذا	هكذا
تجميع	جمع
وباسم	باسم
وفريق	فريق
مدينة	ميناء
سنضمن	تضمن
وعلامة	علامة
ألـف	ألف
❤نصف	نصف
السكر…	السكر
آمسى	أمسى
خط؟	خط
الصباااااح	الصباح
الارض…	الأرض
لأقامة	إقامة
مععاذ	معاذ
السيطر	السيطرة
لمادة	مادة
وساحة	ساحة
بسب…	بسبب
الأساسية	الرئيسية
فنحن	نحن
سمع	سمعت
‏لولا	لولا
إليك”	إليكم
يرسم	رسم
السليم؛	السليم
بمنعطف	منعطف
_يا	يا
بطريق	طريق
قَهْوَةَ	لَيْسَتْ
الجبال…	الجبل
جبل	الجبل
واحد🚶	واحد
وبيع	بيع
كأنَّما	كأنّما
اينما	أينما
فخضعت	واضافت
فقدتّ	فقدت
امّا	أمّا
فيہا	فيها
لحَن	لحن
‏رسم	رسم
صطح	سطح
لكذبة	كذبة
تااافه	تافه
_حتى	حتى
وطباعة	طباعة
وجناح	جناح
﴿كذلك	كذلك
اختبارات	اختبار
حقق	تحقق
اثـر	اثر
جا	جاء
،مات	مات
انخفاضها	الارتفاع
عقل😂	عقل
رخيص…	رخيص
رخيييص	رخيص
محاولت	محاولة
دآئماً	دائما
القوانين	القانون
تماما…	تماما
تعتقدي	تعجبي
سقطو	سقط
شيء🌹	شيء
بالفخذ	الكتف
هاديء	هادئ
المستحيل	الصعب
زُجاج	زجاج
احتلالي	محتمل
عصايا	عصا
القانو…	القانون
ظلَّ	ظلّ
النتن	نتن
وأمام	امام
لأنابيب	أنبوب
ضُعف	ضعف
قوة…	قوة
امتياز،	امتياز
خلّق	خلق
يقتل	قتل
نهر	النهر
جزءمن	جزء
لقائمة	قائمة
اليووم	اليوم
الحركات	الحركة
حسن…	حسن
مجوسي	نجس
الّتي	التي
العظآم	العظام
الاصفر	الأزرق
آسفة	أسف
ماأدى	أدى
ملييون	مليون
ذأت	ذات
لحفظ	حفظ
💣📉فريق	فريق
خاطى	خاطئ
🔴صندوق	صندوق
شكرأ	شكرا
وضرب	ضرب
أرضِ	أرض
محاولتي	محاولة
تضاعف	مضاعفة
دمه	الدم
مسااعدة	مساعدة
قير	جير
ععآد	عاد
باطل،	باطل
مُقارنة	مقارنة
طسم	حم
إلقاء	تلقي
مكآن	مكان
عـاد	عاد
متاجر	متجر
المعركة…	المعركة
متحيون	متوحش
وفوز	فوز
قرَأ	قرأ
تمُر	تمر
بالضبببط	بالضبط
ماء…	ماء
ومتوسط	متوسط
كئييييب	كئيب
قيامك	القيام
متئ	متى
ﺎلحديث	الحديث
الثاني	الثالث
تحديد	تغيير
اللتى	التي
زيارته	زيارة
البازار	المعرض
لَئِن	لئن
قـوة	قوة
امبارح	امس
كأيب	كئيب
أجل	اجل
النظر…	النظر
نعمَ	نعم
اتقان	إتقان
بطاقات	بطاقة
تَأْثِيرُ	تأثير
قووة	قوة
مثل…	مثل
وجھ	وجه
أمامنا	أمامك
هو…	هو
ضربها	ضرب
وأبغض	أبغض
إولئك	أولئك
تام…	تام
الفعِل	الفعل
وتوجية	توجيه
أرآد	أراد
عقدوا	عقدت
ميرور	ميل
تحدُث	تحدث
وَقد	وقد
ايطار	اطار
قآع	قاع
إخر	آخر
هيّا	هيا
تعتمِد	تعتمد
شهر،	شهر
سعيدد	سعيد
لدينآ	لدينا
هاذهي	هذه
​بعض	بعض
اﻻول	الاول
بالمدرسة	المدرسة
اجل	أجل
سماا	سماء
قذيفه	قذيفة
انماط	نمط
غريب💔	غريب
نهائى	نهائي
الوقت،	الوقت
المسساء	الصباح
وخارج	خارج
لنجاح	نجاح
علم…	علم
طبعا	بالطبع
يضمنون	تضمن
النطحة	القفزة
تعرفين	تعرف
مثالاً	مثال
ۈان	وان
جزب	حزب
لاتضمن	تضمن
تجت	تحت
البودر	البخار
مروِّع	مروع
موجات	موجة
سببا	سبب
“لولا	لولا
بفكرة	فكرة
نتيحة	نتيجة
ماشرعه	شرع
فرص…	فرصة
لدىٰ	لدى
المحتل	العدو
إسبوع	أسبوع
الگثير	الكثير
الراقي	الأنيق
النظام	نظام
كُتلة	كتلة
ترصد	رصد
كذلگ	كذلك
لهه	له
ابيض؟	أبيض
يصف	وصف
يصير	صار
امسى	أمسى
صالخ	صالح
لئلا	لكيلا
،اتصال	اتصال
لتلبية	تلبية
‏تحت	تحت
إختراع	اختراع
العشب،	العشب
دفعت	دفع
نـوع	نوع
الإنخفاض	الارتفاع
وسيدة	سيدة
الساحل،	الساحل
قبعات	قبعة
ذوُ	ذو
العظمى	الكبرى
مِمن	ممن
الصفقه	صفقة
الكلب،	الكلب
الدولا	الجنيه
أساسيّ	رئيسي
ظّل	ظلّ
صديـق	صديق
الصفوف	الصف
مُنذ	مذ
ااكل	أكل
أيدي	يد
وامس	امس
وأسع	واسع
ﺎلماضي	الماضي
علامه	علامة
حجرَ	حجر
أمّا	أما
آم	أم
الفـرح	الفرح
جذبة	كذبة
🔴شاهد	شاهد
عليها…	عليها
بـماذا	بماذا
زهرةً	زهرة
شقيقة	شقيق
لاحول	حول
آينما	أينما
بخدمه	خدمة
الحنطة	الذرة
‏‏يا	يا
قَرَّ	هَذِي
عدّ	عد
يكوون	يكون
تُمر	تمر
مباشر”	مباشر
جداااا	جدا
السباحه	السباحة
فقير،	فقير
مرَح	مرح
البنوك	البنك
أسابيع	أسبوع
رائحہ	رائحة
أذًا	إذاً
هدا	هذا
آلف	الف
الحق،	الحق
وعادل	عادل
للصفحة	الصفحة
سِمع	سمع
اقطاعية	مستعمرة
واتحدث	وتحدث
اعلن	اعلنت
وشكرا	شكرا
‏أنتِ	أنتِ
‏يجب	يجب
الّا	إلّا
ممِن	ممن
لمجلس	مجلس
بعيد”	بعيد
قريه	قرية
‏يمكن	يمكن
اذ	إذ
دونما	دون
بجولة	جولة
أسفة	آسف
هذه…	هذه
باطار	إطار
غطا	غطاء
عصاا	عصا
صوتِ	صوت
بعيداَ	بعيدا
إيجابي،	إيجابي
مقاطع	مقطع
اؤلئك	أولئك
الجنيه…	الجنيه
خصوصاً	خاصة
حيوان	الحيوان
أعلن	اعلنت
آقول	أقول
فرصةة	فرصة
حادّ	حاد
مظايقك	مستحيلي
الجمَال	الجمال
يستغرق	استغرق
مُخجل	مؤسف
التشويقة	القفزة
الفن	الغناء
غرفةة	غرفة
الإنقرا�	تلقاء
مقزز	مقرف
عظييم	عظيم
مساوات	مساواة
وتحـدّث	وتحدث
حددوا	حدد
_أنا	أنا
ربطہ	ربطة
مرغوب…	مرغوب
جااء	جاء
الصبااح	الصباح
ربّما	ربما
جناح…	جناح
قذيفتين	قذيفة
وقوى	قوى
ومتوافق	متوافق
ريحة	رائحة
إجابي	سلبي
وقدم	قدم
تحس	تحسين
ذءء	ذا
حديد،	حديد
بنفسجي	رمادي
‏الناس	الناس
بيّد	بيد
الطبيعي	الأصلي
خوووف	خوف
امام…	امام
وكلتا	كلتا
لحظه	لحظة
أسم	إسم
ذهبو	ذهب
فقْرٌ	لَيْسَ
لفرقة	فرقة
مھارة	مهارة
إسود	أسود
قصييييير	قصير
لحظةة	لحظة
مُتقن	متقن
؛لكن	لكن
صبااااح	صباح
عشرة…	عشرة
موظوع	موضوع
مؤلمم	مؤلم
ومكتئب	مكتئب
ترسل	إرسال
عَجب	عجب
الام	الأم
افرك	فرك
خااص	خاص
بخلية	خلية
العضام	العظام
وسّط	وسط
مخزي	مخجل
مـائة	مائة
​درجة	درجة
عملية…	عملية
‏لن	لن
ارتدائها	ارتداء
الجلووس	الجلوس
فعِل	فعل
مباشرة،	مباشرة
والسرعة	السرعة
ارتداءك	ارتداء
منخفظ	منخفض
ستجلب	جلبت
تعزيز	تحسين
ابتكار	اختراع
ذآ	ذا
اسمّر	أسمر
وعقد	عقد
متلث	مثلث
أرتفاع	ارتفاع
الحيون	الحيوان
وسهل	سهل
طَريقولا	ولا
رخييييص	رخيص
يامليح	مليح
موب	مهيب
باختيار	اختيار
خطييييييير	خطير
البنزين	الغاز
الأم	الأب
وهيه	وهي
عملك	عملي
مكتب	مركز
قطاار	قطار
🔴توقع	توقع
السابق،	السابق
مقابل…	مقابل
جيد،	جيد
القيادة	قيادة
الكاملة	كاملة
مقارنتها	مقارنة
ذرةٍ	ذرة
ذهبَ	ذهب
تافهه	تافه
إسفل	أسفل
عجـل	عجل
لأجل	أجل
الچلب	الكلب
حااار	حار
ظربة	ضربة
وضعها	وضع
‏مؤلم	مؤسف
اياه	إياها
بمسار	مسار
شمال…	شمال
‏​ألا	ألا
وشغل	شغل
عصايه	عصا
شمسُ	شمس
جمَال	جمال
إياه	إياهم
أخطار	خطر
خربزي	رمادي
ذُا	ذا
اثنين،	اثنين
،أمّا	أمّا
الخااصه	الخاصة
وقال…	وقال
بكـ	بك
القادم	المقبل
لماع	لامع
امس،	امس
،بعض	بعض
السطيرة	السيطرة
هلمَّ	هلمَّ
يَد	يد
اﻻن	الآن
أفضل…	أفضل
النار،	النار
المعروفة	الشهيرة
السبلينق	الجدول
التيّار	التيار
شــَخْص	لَسْتِ
سواءً	سواء
حَل	حل
حذاءً	حذاء
گثير	كثير
تتفق	توافق
انوا	انه
بيد	يد
اكدت	اعلنت
لجمع	جمع
ألتي	التي
أعتقد	اعتقد
الدم،	الدم
بِكم	بكم
فخخخخخم	فخم
واضح	فاضح
ملكه	ملك
ععام	عام
ورقه	ورقة
بعيدو	بعيد
رأيه	رأي
يوصف	وصف
ملكةة	ملكة
جديده	جديدة
نہاية	نهاية
مصنوعا	مصنوع
مكان،	مكان
​عندما	عندما
لميناء	ميناء
المُحيط	المحيط
أرادَ	أراد
جمآل	جمال
سِيد	سيد
الصفّ	الصف
الرجآء	الرجاء
اوضح	واوضح
بعيداً…	بعيدا
ابدًا	أبدا
مشتـرك	مشترك
أختي	عزيزتي
القادموذلك	المقبل
إستمع	استمع
الغرفه	غرفة
ويائس	يائس
إيّاكم	إياكم
طـول	طول
بخطاب	خطاب
تسعة	ستة
ثلاثون	عشرون
لنمط	نمط
مضحك	محزن
الغدائي	الذاتي
،يا	يا
الرعاية…	الرعاية
هذا…	هذا
لخلية	خلية
بإقامة	إقامة
‏جاء	جاء
رئس	رئيس
اي	أيّ
الوزن…	الوزن
إنخفاض	ارتفاع
أصبع	إصبع
أحمر،	أحمر
آداة	أداة
آلبيض	البيض
متى…	متى
راقي،	راقي
إيجابى	إيجابي
آلضحك	الضحك
خارج…	خارج
الأول،	الأول
وُقد	وقد
إحسآس	إحساس
؟تذكر	تذكر
وأنهن	أنتن
خمسة	ثمانية
،فى	فى
ونفس	نفس
الرعاية،	الرعاية
لگم	لكما
رتفاع	ارتفاع
مرة،	مرة
بدفع	دفع
السابق،،	السابق
تسجييل	تسجيل
حجمّ	حجم
العبــآره	العبارة
بغطاء	غطاء
‏‏لو	لو
آلآقل	الأقل
قصهه	قصة
هُم	هم
منذوا	منذ
ليكم	لكما
المسار…	المسار
بإنتاج	إنتاج
ضربت	ضرب
،مقابل	مقابل
فلان،	فلان
لَّستَ	لَسْتَ
بناا	بنا
كالطور	الجبل
التجربة،	التجربة
وتطلب	تطلب
لتوجيه	توجيه
ححر	حر
صفررر	صفر
اسف	أسف
بااسم	باسم
مصتع	مصنع
كـ	ك
الزانباكتو	الحصان
قَلب	قلب
شكراااا	شكرا
عوض،	عوض
العظميين،	اللتين
ومتى	متى
أنتاج	إنتاج
تشتعل	اشتعلت
وتحدّث	وتحدث
⁰ثم	ثمّ
مسكين؟	مسكين
سسوى	سوى
والتي	التي
تمثيل؟	تمثيل
اياي	إياي
طرقكموفي	وفي
لگم	لكم
الملكية…	الملكية
شديد…	شديد
أربعة	اربعة
أنتي	أنتِ
الماض	الماضي
نوووووم	نوم
عشـر	عشر
شمس،	شمس
لتدفق	تدفق
بمنجم	منجم
الأقل…	الأقل
ستعتمد	تعتمد
جائر،	جائر
الحرب	حرب
،حتى	حتى
فقير…	فقير
،قال	قال
،نعم	نعم
إياه…	إياه
حفرةة	حفرة
الليطاني	النهر
مآذا	ماذا
قاعع	قاع
فسرعان	سرعان
أيّ	إي
الاساسيه	الأساسية
ااي	اي
اسلاك	سلك
لأنبوب	أنبوب
ظھر	ظهر
ايجابى	إيجابي
وتذهب	تذهب
أخذَ	أخذ
المنزل،	المنزل
العبور	عبور
الجآنب	الجانب
وإنتاج	إنتاج
قصص	قصة
وحبل	حبل
وتحقق	تحقق
أختيار	اختيار
وودي	ودي
كتلہ	كتلة
،لا	لا
جذاب550277780	جذاب
قووي	قوى
الشّهد،	الألاء
“لن	لن
قياس،	قياس
ويبدو	يبدو
الكلّ	الكل
المدي…	المدينة
وتظهر	تظهر
فاااااخر	فاخر
رسمة	رسم
ذرةمن	ذرة
وفان	فان
مرحّب	مرغوب
انتشاار	انتشار
أسوداطار	اطار
هنآك	هناك
جااف	جاف
مييت	ميت
الاولى…	الاولى
التكلفه	التكلفة
المتّزن	الرقيق
وشبه	شبه
،كما	كما
ولماذا	لماذا
إياها،،﴿	إياهما
آختلف	اختلف
ابن…	ابن
توصيف	وصف
قوى	قوي
نغسه	نفسه
نببه	بري
المكتب	مكتب
مممكن	ممكن
“ودي	ودي
غيير	غير
جمييييل	جميل
مرفووض	مرفوض
بمِن	بمن
بِيَد	بيد
نووع	نوع
وأيسر	أيسر
ببناء	بناء
أيضاا	أيضا
«حزب	حزب
مقدس…	مقدس
أگثر	أكثر
تهجاء	تهجى
جيمع	جميع
أقواكَ	رويدك
خسيس	خبيث
وقذيفة	قذيفة
فضه	فضة
اعطا	أعطى
وبندقية	بندقية
هوآء	هواء
مليار	مليون
ششهر	شهر
وعوض	عوض
حزء	جزء
أخري	اخرى
والخلابة	الطبيعة
واللاتي	اللاتي
حقيقيه	حقيقية
هااائل	هائل
الجرانيت	الخشب
بُقعة	بقعة
هكذآ	هكذا
مانشتاقنشقى	ماانفك
باااال	بال
اعاة	اعادة
ممَّن	ممن
•لئن	لئن
تاام	تام
بدأ	ابتدأ
مُترف	مترف
مُمتع	ممتع
اياها❤	إياهن
العكس😂	العكس
8عناصر	عنصر
غطائها	غطاء
حافلة	شاحنة
شراب،	شراب
الصفحات	الصفحة
لخدمة	خدمة
اللأمم	للامم
نُقطة	نقطة
مئه	مائة
صفحة	الصفحة
لحظات	لحظة
ممكم	ممكن
الشرع	شرع
حسنَ	حسن
علييك	عليك
القليل،	القليل
المتسوى	الجدول
امتدادا	امتداد
وقال	وقالت
قـرب	قرب
تجربت	تجربة
كي	لكي
وبط	بط
ماجلانرحلة	رحلة
أُخرى	اخرى
سآعه	ساعة
بأيدي	بيد
أبقىٰ	أبقى
اللتي	التى
لبلد	بلد
بحرق	حرق
انقلبت	انقلب
الكبيرة	الكبرى
إستحال	استحال
السلالات	المعادن
برا	خارج
الكلب؟	الكلب
جمع	أجمع
الاتصال	اتصال
تعلمم	تعلم
و11	و6
متجر…	متجر
سجلوا	سجل
مارح	راح
💣⭐فريق	فريق
الازق	الأزرق
الماضي	الحاضر
غريبَ	غريب
ايامم	ايام
أكثر	اكثر
دوار	شارع
قياس…	قياس
مهارات	مهارة
معطفٍ	معطف
اللذين	الذين
‏قصيدة	قصيدة
باسم…	باسم
كماا	كما
”إِنَّ	إِنَّ
درحة	درجة
بأنها	انها
سحابت	سحابة
الملكة	ملكة
محتاجة	محتاج
تممم	تم
🔴بحيرة	بحيرة
قوي…	قوى
آختر	اختر
رئ…	رئيس
مرّة	مرة
جدران	جدار
الإسم	إسم
الطبيعه	الطبيعة
بريّ	بري
عدْ	عد
زائرولم	ولم
يا…	يا
ينبغى	ينبغي
هنا…	هنا
​قال	قال
الأب،	الأب
النضر	النظر
قوي	قوى
الف	ألف
التنفيخ	الجلد
بوقف	وقف
أيار	ايار
وتحوي	تحتوي
إي	آي
بكوكب	كوكب
ككُل	ككل
إذاً	إذن
دُون	دون
نادرة	نادر
بمكان	مكان
العبار…	العبارة
يزال	مازال
الموضو…	الموضوع
فـوق	فوق
بعلم	علم
آلفعل	الفعل
،ثمّ	ثمّ
اﻻخضر	الأخضر
الهبيط	التل
ذأك	ذاك
مزارعنامحصول	محصول
طويل…	طويل
حـر	حر
،كلاهما	كلاهما
عليگ	عليك
‏دراسة	دراسة
مدينة	قرية
محتاجه	محتاج
بسرعه	بسرعة
بدوني	دوني
مليارات	مليار
صباحآ	صباحا
سيوضح	واوضح
،ومن	ومن
بفترة	فترة
الأخيره	الاخيرة
تلقيه	تلقي
ذاتٌ	ذات
حلوو	حلو
ودعم	دعم
شئ	شيء
إليكمآ	إليكما
لكك	لك
وسير	سير
مُطاردة	مطاردة
المرامية	التربة
سكـة	سكة
لقمّة	لقمة
هاؤلا	هؤلاء
عاادل	عادل
دعوی	دعوى
أسبوعين	أسبوع
“جاء	جاء
مبارات	مباراة
دخولها	دخول
‏​خلف	خلف
مزيجمن	مزيج
عصاية	عصا
ضوءَ	ضوء
بحـر	بحر
​اذا	اذا
هاااا	ها
‏اختر	اختر
مسمى	إسم
أسواق	سوق
بالمدينة	المدينة
اللقاء	لقاء
واتوقع	اعتقد
حـرف	حرف
أتقان	إتقان
،إنما	إنّما
طباعه	طباعة
تريدون	تريد
حتى…	حتى
بررررري	بري
مااعتقد	اعتقد
اللّذين	الذين
فظّ	فظ
ظهر…	ظهر
لعينآ	لعين
لَعَلَّ	لَعَلَّ
قدِيم	قديم
إنتظر	انتظر
حليو	حلو
يغير	تغيير
قطعه	قطعة
للفوز	الفوز
يتلذذن	إياكن
المخيم	مخيم
بععض	بعض
فهّلا	هلّا
؟إذاً	إذاً
موجه	موجة
عليييييل	عليل
طاائر	طائر
الحصآن	الحصان
آلرجال	الرجال
التئ	التى
ببحر	بحر
خرافي	رهيب
زيارتي	زيارة
مباريات	مباراة
حَتَّى	حَتَّى
تحربة	تجربة
الرييع	الربيع
بأسم	إسم
الليل،،	الليل
والقانون	القانون
الجبه…	الجبهة
أب؟	أب
مؤلم	مخيف
وسمع	سمع
هيئه	هيئة
أسباب	سبب
ايّسر	أيسر
إتصال	اتصال
سيّد	سيد
سمااء	سماء
االعشب	العشب
شغلل	شغل
إي	أيّ
وكلاهما	كلاهما
هَذِهِ	هَذِه
تذكروا	تذكر
نُسخة	نسخة
يدّ	يد
يترك	ترك
تحقّق	تحقق
وتحمل	تحمل
قبعةة	قبعة
وقرية	قرية
بَات	بات
‏​اول	اول
فبالتالي	وبالتالي
وشكراً	شكرا
صقط	سقط
نجاحهم	نجاح
بالجص	الخشب
آبن	ابن
محززن	مفزع
عمله	عملي
اكثر	أكثر
واا	وا
مااعلنت	اعلنت
عبُور	عبور
النفس،	النفس
آخرر	آخر
قول؛	قول
أنفق،	أنفق
اليكَ	إليكَ
إحراق	حرق
دعودة	دعوة
مشروب	شراب
متی	متى
الزهيريصالح	صالح
فهل	هل
لمنخفض	منخفض
أبن	ابن
حيااة	حياة
سَماء	سماء
مرفوض،	مرفوض
ألدم	الدم
مترف،	مترف
ماهوجمع	جمع
نعوووم	ناعم
مكروه❤️	مكروه
آاي	آي
مفاجأ	مفاجئ
انخفاضه	الارتفاع
الاسنان	أسنان
قرّب	قرب
أى	أي
المنخفض	منخفض
“لما	لما
لطييف	لطيف
شهور	سنوات
أحساس	إحساس
بمارسة	ممارسة
الجمّال	الجمال
وشاق	شاق
جيّد	جيد
هي	هيا
ساعه	ساعة
الموضوع؟	الموضوع
الی	الى
الضجيج	الضوضاء
خللاً	خلل
اللذان	اللتين
لعقد	عقد
وضعف	ضعف
بسيطة…	بسيطة
مسأله	مسألة
أكذوبة	كذبة
الْمَرَضُ	مريض
متوافقه	متوافق
تقيلة	ثقيلة
ااهل	أهل
|جدول	جدول
أقل…	أقل
ولَم	ولم
للبنك	البنك
شہر	شهر
دويله	دولة
متوسط؟	متوسط
وَيْحَ	لَيْتَ
إليكما…	إليكما
عشرة	عشر
كرييه	كريه
بسرعه،	بسرعة
غضبَ	غضب
وبحر	بحر
نقطہ	نقطة
علىأسس	أسس
عجييييب	عجيب
جدوال	جدول
لك💙	لك
وحزب	حزب
لعبوا	لعب
بحي	حي
الفوسفات	الغاز
رنة	نغمة
مخزً	مخز
أبيض	أسود
لائحةالإرهاب	الذراع
الللغة	اللغة
آليم	أليم
ذهب،،	ذهب
مُفاجئ	مفاجئ
الربيـع	الربيع
المدينة_المنورة	المدينة
إياهـ	إياهن
بالضبط،	بالضبط
‏الآن	الآن
وصوت	صوت
غظب	غضب
لبقية	بقية
سوفى	سوف
تواصل…	تواصل
لِكي	لكي
تتناسب	تناسب
لماا	لمّا
عظيم…	عظيم
فرقه	فرقة
أوشكَ	أوشك
قلليل	قليل
قليل…	قليل
آحساس	إحساس
الصفحه	الصفحة
آناقه	أناقة
مريع	مرعب
عليه💛	عليه
لتصميم	تصميم
سمحح	سمح
الجبهه😂😂	الجبهة
مليح،	مليح
طائرتين	طائرة
ثالث	ثان
صهيوأمريكي	جهنمي
للقاء	لقاء
اي	آي
مهيب…	مهيب
شخصاََ	شخصا
وانها	انها
جبلٍ	جبل
‏​عندما	عندما
اﻵن	الآن
لملك	ملك
ابدا	أبدا
،كانت	وكانت
غادروا	غادر
فوقق	فوق
طريـف	طريف
،سواء	سواء
العقوبه	عقوبة
عمليه	عملية
السادس	الثاني
بيں	بين
المعارك	المعركة
أعاده	اعادة
آنيق	أنيق
اذنّ	إذن
🔴دراسة	دراسة
وضد	ضد
صيحه	صيحة
الاوكسجين	الأكسجين
طلما	طالما
بأن،	بان
عصبات	عصابة
حصلتي	حصلت
الجنوب،	الجنوب
الكلام…	الكلام
فا	ف
‏​بعد	بعد
أنبرى	انبرى
محزن	مخجل
ساعة،	ساعة
الأبتسامة	الابتسامة
بالمقارنة	مقارنة
وإينما	حيثما
ثُمَّ	ثُمَّ
منغسل	غسل
صديق،	صديق
​​لو	لو
مسآر	مسار
اﻷخضر	الأخضر
إنمَا	إنّما
أيضًا	ايضا
محاربة	حماية
‏اخر	آخر
آفضل	أفضل
كآد	كاد
المصلحة	مصلحة
كُلماا	كلّما
والأب	الأب
تحددين	حدد
اانيق	أنيق
مَرح	مرح
فـن	فن
🔴شركة	شركة
أمامك…	أمامك
بماذ	بماذا
تقف	وقفت
كَنَّ	كَأَنَّ
قاعدهه	قاعدة
حاليا	الآن
لصوت	صوت
أضحی	أضحى
يحدت	يحدث
بموضوع	موضوع
الإنسولين	الأكسجين
بآرع	بارع
مكاان	مكان
لاتحمل	تحمل
مجموعه	مجموعة
كفايات	قياس
خاصة،	خاصة
؛ومن	ومن
هّذهِ	هَذِه
أي	آي
السفر،	السفر
الغناء،	الغناء
والقيام	القيام
الخاصة؟	الخاصة
الخوف	خوف
ظهرآ	ظهرا
تيانق	تين
وأداة	أداة
سببّ	سبب
ايّاه	إياه
والأرقام	الأرقام
إلاا…	إلا
تام،	تام
كُلما	كلّما
وتيـار	تيار
لأكن	لكن
سط	وسط
مستودع	مصنع
إلیك	إليكما
بناء…	بناء
نهاية	بداية
الساق،	الساق
وإثبات	إثبات
،كيفما	كيفما
إلّ…	إلّا
علمٍ	علم
نُصف	نصف
‏​لماذا	لماذا
الشَّيطانَ	كلَّا
مَّاذَا	عَمَّا
منشغل	مشغول
المقبل…	المقبل
تخيّل	تخيل
ضربه	ضربة
عيين	عين
الصبّاح	الصباح
فغل	فعل
سيّئه	سيئة
مهي	مهيب
قليل،	قليل
بدآ	بدأ
بداء	بدأ
وديّ	ودي
أما	أمّا
👑كل	كل
النهائي	نهائي
سهـل	سهل
كَانّتْ	لَسْتِ
مفأجاه	مفاجأة
باط…	باطل
اﻷخيرة	الاخيرة
‏‏إن	إن
شتـاء	شتاء
الوقٺ	الوقت
شِبه	شبه
الحيوآن	الحيوان
وحصلت	حصلت
أيضاََ	أيضا
سماء…	سماء
ياعزيزتي	عزيزتي
بذهني	ذهني
خبيث	خسيس
النظر،	النظر
عآم	عام
رُبما	ربما
الوادي…	الوادي
نابغه	نابغة
لعامود	عمود
له❤	له
أيّ	آي
تئثير	تأثير
قصيدة…	قصيدة
زنبقة	زهرة
الركبه	الساق
واي	اي
ونِعمَ	نِعْمَ
​هناك	هنالك
فليرمِ	رمي
مريع،	مريع
مظبوط	مضبوط
اﻷن	الآن
كذيل	ذيل
مليّح	مليح
أمنة	آمنة
تيارنا	التيار
وتجاره	تجارة
لمذا	لماذا
«قياس»	قياس
عشر…	عشر
لشجرة	شجرة
وحدا	وحدة
الانف،	الأنف
كبييييير	كبير
لوون	لون
أسفه	أسف
النفس؛	النفس
تطالب	مطالبة
،،وقد	وقد
ودون	دون
عجّل	عجل
اياهم	إياهم
قيم…	قيمة
اخرى…	اخرى
المراكشية	الشهيرة
،لكن	لكن
كهربائية	كهربائي
وسَط	وسط
متأخرة	متأخر
اقتلب	انقلب
موغوب	مرغوب
السبب؟	السبب
الانيق،	الأنيق
الام	الأب
تمامآ	تماما
والقسم	القسم
وسسط	وسط
قصةةَ	قصة
بِصوت	بصوت
حبِل	حبل
\/نبيل	نبيل
مثالٍ	مثال
خلل…	خلل
مراح	راح
مادة…	مادة
••كل	كل
التكلفة،	التكلفة
مكتأب	مكتئب
بعيداا	بعيدا
الذّهن	ذهني
قراء	قرأ
أَنفق	أنفق
مُشترك	مشترك
مُعاذ	معاذ
إضافة…	إضافة
قَلْبكِ	لَسْتِ
الثانيه	الاولى
لدهن	دهن
مخزٍ	مخز
‏رجل	رجل
فيجب	يجب
الإمة	الأمة
أَنْبَاءِ	لَيْسُوا
المثالى	المثالي
مؤلم	مخجل
تحسش	نحس
شّديد	شديد
الكلآم	الكلام
بصفقة	صفقة
عليھا	عليها
لفهه	لفة
هآ	ها
متاخـر	متأخر
ماتعرف	تعرف
الأطفال،	الأطفال
‏​لولا	لولا
شكراا	شكرا
“طالب	طالب
كَرب	كرب
الگلام	الكلام
،،،،،عدد	عدد
فقدتْ	فقدت
لعينن	لعين
ذرة❤️	ذرة
قـلب	قلب
كأيِّ	كأيّ
والددم	الصلب
‏ودي	ودي
أَنَّ	أَنَّ
‏قال	قال
كذل…	كذلك
اللتين	اللتان
سوفه	سوف
المسار،	المسار
negative_emojiإياكم	إياكم
لتعليم	تعليم
لديهه	لديه
حينَ	حين
قوائم	قائمة
ٲهل	أهل
وتحتوي	تحتوي
حسيء	حسي
احتدّ	استحال
مِن…	مِن
شخصين	اثنين
آمنة…	آمنة
المياه	الغاز
أدَّى	أدى
صراخات	صرخة
بسحب	سحب
يختلف	تختلف
تقرّر	تقرر
قاموسنا	قاموس
بأيد	بيد
الانسب	المثالي
وإن	وان
كـأي	كأيّ
سيئ	جيد
،جاء	جاء
إستثنائي	استثنائي
قوووي	قوي
توقف	وقف
ورديء	رديء
ااجل	اجل
فعـل	فعل
قطعت	قطع
وغادر	غادر
مصطلع	مصطلح
الضرورھ	الضرورة
يعتقدان	يعتقد
أبتدا	ابتدأ
ثمانية	خمسة
ٺحسين	تحسين
استلزم	استغرق
وقفوا	وقفت
للنظام	النظام
قاعده	قاعدة
،،لكن	لكن
آآميـن	آمينَ
عميّق	عميق
وجاف	جاف
أب،	أب
حآفة	حافة
وااكد	واكد
رُؤُوسُ	بِئْسَ
وخدمة	خدمة
نوعٍ	نوع
مداهمة	مطاردة
ونجمة	نجمة
امّا	أما
احد♡	احد
خطيبة	زوجة
الوسيلتان	اللتان
الثلج،	الجليد
تاريخنا	التاريخ
دِهن	دهن
الدهب	الذهب
الأساسية…	الأساسية
سيدُ	سيد
طاقين	طاق
وردة	زهرة
القافويلذ	المعنى
جلبو	جلبت
حس	حسي
لغرفة	غرفة
إلزامهم	القيام
وأقل	أقل
جليل،	جليل
فِيما	فيما
طبيبعي	طبيعي
ولم…	ولم
وشرس	شرس
بالأنف	الأنف
وقالت	وقال
الموسيقا	الموسيقى
✨✨من	من
مباراة…	مباراة
‏​كم	كم
حدث	يحدث
استعمال	استخدام
شخصّ	شخص
مايلمس	لمس
ستة	خمسة
واينما	كيفما
بلد…	بلد
وغرامة	غرامة
خائف،	خائف
شركہ	شركة
اتصال…	اتصال
بسيطه	بسيطة
والنتيجة	النتيجة
وفى	وفي
خَلق	خلق
السحب	سحب
ثمانيه	ثمانية
أى	أيّ
وتعليم	تعليم
عينْ	عين
نقول	أقول
نادم،	نادم
وحطم	حطم
نافدة	نافذة
الطبيعة…	الطبيعة
علوم_الطقس	الطقس
لا…	لا
لديك	لدينا
عواميد	عمود
ذرت	ذرة
وجذاب	جذاب
​كلما	كلّما
ۈتر	وتر
يتركون	ترك
سيبدو	يبدو
بضربة	ضربة
الولادة،	الولادة
البالات	الحقل
عِدّ	عد
نهآئي	نهائي
شجره	شجرة
تسمح	سمح
اابقى	أبقى
اعلا	أعلى
مذهل	مدهش
وأهل	أهل
لَكِنَّهُ	لَكِنَّ
‏هم	هم
بِنا	بنا
كئيب،	كئيب
المعرفي	الذاتي
وماذا	ماذا
سيدّ	سيد
الولادة؟	الولادة
أُرسِلت	أرسلت
غرفه	غرفة
أهل	أهل
ضِمن	ضمن
”بس	بسّ
بطئ	بطيئة
يغادر	غادر
آحمر	أحمر
جديدة”	جديدة
سسمح	سمح
النّفس	النفس
للشعر	الشعر
عجل🍃	عجل
جسن	حسن
تتعجبي	تعجبي
الثانى	الثاني
الأخظر	الأخضر
موانئ	ميناء
اعظم	أعظم
شنيع،	فظيع
قطُّ	قطّ
افف	اف
طبخات	طبخ
إيسر	أيسر
آي	أي
الأوكسجين	الأكسجين
مستفز	مقرف
‏مقطع	مقطع
وحماية	حماية
اغنيه	أغنية
خلايا	خلية
قريبآ	قريبا
أدت	أدى
لمصنع	مصنع
أسفة	أسف
يعلق	علق
آمنة،	آمنة
تشتمل	تحتوي
قلب❤	قلب
حلقة	فقرة
ملايين	مليار
كراسي	كرسي
الآن	حاليا
الثاني	الاول
‏لما	لمّا
وعجلة	عجلة
عليه…	عليه
الرجااء	الرجاء
اسباب	سبب
أعتيادي	معتاد
الشطان	شيطاني
وترٌ	وتر
ويبدأ	بدأ
حت…	حتى
‏غرفة	غرفة
قآاع	قاع
تخيلي	تخيل
ومكروب	مكروب
بقره؟	بقرة
لَكِنَّ	لَكِنَّ
انظمام	انضمام
آلصباح	الصباح
يوشك	أوشك
إما	اما
مفاجآت	مفاجأة
وااااضح	واضح
أَيَّانَ	عَمَّا
الان	الآن
جُنوني	جنوني
عين،	عين
مططر	مطر
،،،ومن	ومن
حسيّ	حسي
بخارج	خارج
توجه	توجيه
المعركه	المعركة
تحول	تحوّل
‏​مقطع	مقطع
صرخه	صرخة
وقاعدة	قاعدة
بفرقة	فرقة
بائس،	بائس
بِكَثْرَةٍ	لَيْسَتْ
آجل	اجل
تُهَم	تهمة
وخصوصا	خاصة
نقطةة	نقطة
،وفي	وفي
بيَ	بي
والرعاية	الرعاية
احتفِظ	احتفظ
الخامس	الثالث
يوووم	يوم
يطيره	يطير
مجرى	مسار
ظهـر	ظهر
جافّ	جاف
بالشعر	الشعر
اﻷقل	الأقل
المسعف	الطبيب
فووز	فوز
ابتدا	ابتدأ
دواء	غذاء
قبل…	قبل
دآئما	دائما
إشعاراً	إشعار
الاساسية	الرئيسية
الئ	الى
مااء	ماء
قـول	قول
لذييييييذ	لذيذ
الفوز	فوز
|وكالة	لوكالة
فإن	فان
لتناسب	تناسب
أخرئ	اخرى
عقلٍ	عقل
‏شجرة	شجرة
العكس،	العكس
سته	ستة
ڤان	فان
الؤقت	الوقت
وجاء	جاء
آعلنت	اعلنت
تلک	تلك
أبداً”	أبدا
خورافي	خرافي
فہنَاكَ	هَاتِي
العظام…	العظام
عوّض	عوض
ركنيه	رمية
مُكتئبه	مكتئب
حقيقه	حقيقة
مصانع	مصنع
شغل😂😂	شغل
العاصمة،	العاصمة
مبارة	مباراة
لعملية	عملية
قيمه	قيمة
موقفك	موقف
وركوب	ركوب
اَي	أي
مقارب	مماثل
هؤلا…	هؤلاء
ااه	آه
ﻻكن	لكن
مفترق	منعطف
أجمع،	أجمع
_صحيح	صحيح
القاره	القارة
الحُكم	الحكم
وقاطع	قاطع
الكبري	الكبرى
واسعٌ	واسع
اذار	ايار
قررريب	قريب
وتتطلب	تتطلب
ايد	يد
الحاصل	حاصل
سبعه	ستة
خاءف	خائف
العباره	العبارة
نفسو	نفسه
وعمود	عمود
سطـح	سطح
فقِير	فقير
كتلةة	كتلة
دونه	دونك
أتجاه	تجاه
سوفاء	سوف
بائس	يائس
تامم	تام
ياها	إياها
سريع،	سريع
تختلِف	تختلف
النتايج	النتيجة
ألات	آلة
آليوم	اليوم
رئيسة	رئيس
قادرهعلى	قادرة
الأخضر	الأزرق
حسسي	حسي
الجلل	جلل
مآئه	مائة
وتلبية	تلبية
الذّين	الذين
‏ثمة	ثمّة
بكم…	بكما
خطوه	خطوة
الغرامات	غرامة
طووول	طول
اليوووم	اليوم
بُحيرة	بحيرة
رمـل	رمل
اخد	أخذ
فنانة	نجمة
حافه	حافة
😊فن	فن
اعجازي	إعجازي
بدايہ	بداية
بقطاع	قطاع
هادئ،	هادئ
دونكِ	دونك
الأُم	الأم
آلعظآم	العظام
جاهزه	جاهزة
قوي…	قوي
لحالة	حالة
تؤشر	تشير
حبّل	حبل
التسلق	تسلق
حااااار	حار
حديقةة	حديقة
حدثت	حدث
بدلآ	بدلا
متااخر	متأخر
عقيم	سقيم
بسبطة	بسيطة
إلا	الا
يقرر	تقرر
ذرةَ	ذرة
ثمة	ثمّة
الرقص	الغناء
بصوتٍ	بصوت
زيوت	زيت
نفسس	نفس
البعضَ	البعض
عبُوس	عبوس
حاليآ	حاليا
درسات	دراسة
البحر،	النهر
النوع	نوع
،متى	متى
حيثُما	حيثما
السوأل	السؤال
تسعةة	تسعة
شراء…	شراء
العمل…	العمل
أوبضع	بضع
بمادة	مادة
اللذي	الذي
‏عزيزتي	عزيزتي
القليل…	القليل
مُنظم	متقن
ضغف	ضعف
سمآ	سماء
هئية	هيئة
هبُ	هبّ
دونـي	دوني
ؤهو	وهو
حدائق	حديقة
خمس	خمسة
بقائمة	قائمة
ونجس	نجس
يإسم	باسم
الفضاء،	الفضاء
البيْض	البيض
كااملة	كاملة
عليها،	عليها
وبشكل	بشكل
لصندوق	صندوق
فلانه	فلان
الحزيرة	الجزيرة
تحتآج	تحتاج
اصبح	أصبح
ساعہ	ساعة
يحتوي	تحتوي
ذء	ذا
كهربائى	كهربائي
شى	شيء
يُمكن	يمكن
خار…	خارج
وضيييييييع	وضيع
عيب”	عيب
عيـن	عين
أعظم…	أعظم
قطعةة	قطعة
رخيص؟	رخيص
أبّ	أب
​​نظيف	نظيف
صاالح	صالح
غسيل	غسل
خطييير	خطير
«لئن	لئن
وحر	حر
هالموسم	الموسم
العين،	العين
اختلالات	خلل
كوكب…	كوكب
سعيد،	سعيد
قووي	قوي
ۈحيد	وحيد
عشرةَ	عشرة
مخييف	مخيف
اثنيين	اثنين
اٍثم	أثم
♡غني	غني
خَلا	خلا
القفز	تسلق
الوقُوف	الوقوف
هائِل	هائل
وذو	ذو
ضدها	ضد
،يمكن	يمكن
إلفعل	الفعل
سسعيد	سعيد
هادء	هادئ
مقصود؟	مقصود
تمثييل	تمثيل
_بذرة	بذرة
بسسب	بسبب
دوني؟	دوني
ولذلك	وبالتالي
بسرعهه	بسرعة
محتاجين	محتاج
رياح	الرياح
حافةة	حافة
«الدولار»	الدولار
رسلت	أرسلت
البييض	البيض
سواً	سواء
القفولوش	المال
خطير؟	خطير
رئيسى	رئيسي
قى	فى
‏​إذا	إذا
شيئ	شيء
الذهب،	الذهب
جذرة	الجذر
ذاكَ	ذاك
رقم	الرقم
صناعة…	صناعة
سححب	سحب
سريع√	سريع
قيادتها	قيادة
صغيير	صغير
ا	وا
تصنيع	صناعة
هيااا	هيا
العواصف	الرياح
ويائس	بائس
محبوبن	محبوب
تمثيله	تمثيل
تابعوا	تابع
شـارعٍ	شارع
لدی	لدى
يدفع	دفع
الحق،،	الحق
طبيعى	طبيعي
آحتفظ	احتفظ
دئما	دائما
وكمال	كمال
الثالث	الثاني
بالفوز	الفوز
يسقط	سقط
لسباق	سباق
بسيييطة	بسيطة
اليو…	اليوم
فقـير	فقير
وتفاحه	تفاحة
وتذكر	تذكر
نسخه	نسخة
تعيس،	تعيس
ااثم	أثم
أصبـح	أصبح
النجاح	نجاح
العصائب	الحشد
سُهولة	سهولة
وضيع…	وضيع
صالحصالح	صالح
‏​الفتيات	اللواتي
سووف	سوف
أَرَاكِ	لَسْتِ
سميّك	سميك
العبآرة	العبارة
والظهر،	الرقبة
الآنيق	الأنيق
نتمنى	نأمل
الرائعة	الشهيرة
وسهولة	سهولة
ورائحة	رائحة
انہ	انه
عبور،	عبور
سكّه	سكة
هلاّ	هلّا
حاااااار	حار
أفظل	أفضل
تجربته	تجربة
شخض	شخص
الإنيق	الرقيق
عقوبةعلى	عقوبة
بك💗	بك
•لو	لو
ويقول	وقالت
مشغووول	مشغول
ملح،	ملح
أفلان	فلان
ينبري	انبرى
ويطير	يطير
قريباا	قريبا
المتجر	متجر
“صندوق	صندوق
ووقف	وقف
واينما	حيثما
بدلًا	بدلا
،إنّما	إنّما
ميناءي	ميناء
أستطعتوا	استحال
وصفقة	صفقة
اﻻصفر	الأصفر
جميييل	جميل
خاطيء	خاطئ
الليل،	الليل
،بديع	بديع
“بين	بين
تفآحة	تفاحة
تظمن	تضمن
بجدار	جدار
فـلان	فلان
وتم	تم
تالق	تألق
دايماً	دائما
ممجوج	مقيت
تَغيير	تغيير
مُقرف	مقرف
مفسد	فاسد
وزيت	زيت
،توقع	توقع
جداول	جدول
بـالضرورة	الضرورة
حفرةً	حفرة
أياه	إياها
سيـد	سيد
اليمنهؤلاء	أولاء
من…	من
الشباب…	الشباب
بكم	بكن
​لولا	لولا
“نحن	نحن
سكہ	سكة
وقف	وقفت
لفريق	فريق
تأكيد	مؤكد
الآطفال	الأطفال
طائره	طائرة
صح…	صحيح
نقاط	نقطة
العمل❤	العمل
بالضبظ	بالضبط
الفف	الف
مصنعين	مصنع
جنووني	جنوني
التاريخ…	التاريخ
وتوفير	توفير
أينَ	أين
✨✨لا	لا
الحالي	السابق
نرجوا	الرجاء
بصناعة	صناعة
حددت	حدد
حر،	حر
محبوبمابين	محبوب
اضافة	إضافة
توجيهه	توجيه
انتقال	انضمام
إِلَيْكَ〰〰〰〰♡	إلَيْكَ
اكل	أكل
وربما	ربما
فضيع	فظيع
عند…	عند
اشترا	اشترى
ظربه	ضربة
قدّم	قدم
مقعدًا	مقعد
لِطَيْفِ	لَيْتَ
إِذ	إذ
بازر	بارز
اثار	اثر
الإبتسامه	الابتسامة
مع	معا
الجمال،	الجمال
غادرو	غادر
تُعلن	اعلنت
ونظيف	نظيف
دائـرة	دائرة
ورق،	ورق
القط،	القط
تنموا	تنمو
أيضًا	أيضا
عللق	علق
مكروووه	مكروه
ارسلت	أرسلت
تدفّق	تدفق
آلةٍ	آلة
بهـا	بها
الريح	الرياح
‏اكثر	اكثر
ونحس	نحس
حـْـْزب	حزب
تححت	تحت
تألق…	تألق
أرااد	أراد
،بأن	بان
وبلد	بلد
”إن	إن
الطرب	الغناء
‏نصف	نصف
كثيرر	كثير
‏مات	مات
دُونك	دونك
ارجع	رجع
فعل،	فعل
آلموت	الموت
سباحة	السباحة
السيطره	السيطرة
والأنف	الأنف
حرآرة	حرارة
بذرةٌ	بذرة
قاربَ	قارب
أنتم	أنتن
وتوقع	توقع
ذٰلك	ذلك
سمآء	سماء
ركوبك	ركوب
قريبّ	قريب
كأنَّها	كأنّما
تناحس	مغناطيس
حذيان	حذاء
؛لم	لم
اسمر	أسمر
وحليب	حليب
شحص	شخص
ذاا	ذا
علّق	علق
رائيسى	رئيسي
العبارھ	العبارة
محاوله	محاولة
فلماذا	لماذا
أمس	امس
ايضاً	ايضا
‏​ودي	ودي
الموسيقي	الموسيقى
قديمَ	قديم
رأيّ	رأي
الوضوع	الموضوع
جاهز	جاهزة
مشارك	مشترك
ٺحت	تحت
اﻷبتسامه	الابتسامة
صغير،	صغير
⁰سرعان	سرعان
يمگن	يمكن
كهربى	كهربائي
،بسّ	بسّ
ﺎلحب	الحب
،نفس	نفس
مقعداً	مقعد
وكم	كم
وصور	صور
‏سوف	سوف
♡ومن	ومن
تسليمنا	تزويد
صفر…	صفر
قوُل	قول
يطيرون	يطير
عندمآ	عندما
كارثى	مماثل
سوىَ	سوى
الإ	الا
_إذا	إذا
الفوارق	الفجوة
السرعة…	السرعة
تسعہ	تسعة
المدرسه	المدرسة
ذلكمْ	ذلكم
‏​حين	حين
وراقب	راقب
الفئتين	الفئة
لكن…	لكن
القانون،	القانون
حلمً	حلم
أنكما	أنتما
كِذا	كذا
حُسن	حسن
تلقاءِ	تلقاء
القندرة	الحشرة
مبهر	باهر
الوﻻدة	الولادة
وأب	أب
_لن	لن
فوق…	فوق
ادا	اذا
إف	اف
وتوجيه	توجيه
الاقل	الأقل
وأقبل	أقبل
وفيما	فيما
علئ	على
للحكم	الحكم
آلوقوف	الوقوف
الغه	اللغة
صحافة	الصحافة
___لا	لا
بِما	بما
لكتلة	كتلة
_لما	لمّا
واحد،	واحد
عايله	عائلة
عليكـ	عليك
كامل،	كامل
علـم	علم
حياةً	حياة
منزلها	منزل
ذاكك	ذاك
بنفس	نفس
الكهرباء	الطاقة
أسفلَ	أسفل
‏حسن	حسن
عليها🌹	عليها
طويل”	طويل
اوتار	وتر
حُيث	حيث
متأقلم	متوافق
الحرك…	الحركة
النباه	الوادي
مُنحط	منحط
المسكين	مسكين
قوى…	قوى
ثاااني	ثان
إرتفع	ارتفع
تريدُ	تريد
،أكثر	أكثر
حاله	حالة
،غريب	غريب
اب؟	أب
حزيين	حزين
عصابه	عصابة
لنغمة	نغمة
متال	مثال
تكلفته	التكلفة
؟أين	أين
نآدر	نادر
أعلنت	اعلنت
مُحزن	مخجل
ورفع	رفع
أَنَّى	أنّى
الضغط…	الجلد
الرقام	الأرقام
معععاذ	معاذ
آلصعب	الصعب
إذاأقبل	أقبل
الاخضر…	الأصفر
النّاس	الناس
فاخرخلاص	فاخر
الأن	الآن
البنفسجي	الأزرق
أقبلأقبل	أقبل
،،هم	هم
السحلية	الحشرة
مؤؤلم	مؤلم
مـات	مات
عكس	العكس
بارد؟	بارد
وبديع	بديع
عجل،	عجل
الموُت	الموت
المئة،	المائة
آلعمر	العمر
​كيف	كيف
مرفوص	مرفوض
والسكر	السكر
وبقرة	بقرة
خنفس	خفاش
ألى	إلى
ألى	الى
العدوا	العدو
إستغرقت	استغرق
وقّف	وقف
لمنطقة	منطقة
الفستان	فستان
وأتقان	إتقان
ألاب	الأب
“عدم	عدم
صآلح	صالح
الأم؟	الأم
بالارنب	القط
الذيّن	الذين
تسويق؟	تخمين
لقطاع	قطاع
دونَ	دون
الجلب	الكلب
واعادة	اعادة
كالشرق	الشرق
هذاك	ذاك
ذاكـ	ذاك
قادرين	قادرة
بدلأ	بدلا
ذلكك	ذلك
اسطوري	استثنائي
لباقي	بقية
يذهب	تذهب
وتلبيةً	تلبية
هُناك	هناك
لبناء	بناء
صُوت	صوت
ملعوون	ملعون
تلبيتهم	تلبية
الضرورة،	الضرورة
إليم	أليم
مخجل	مخيف
هما…	هما
العيّنة	الفئة
الكبرى…	الكبرى
حرفٍ	حرف
الحماية	الرعاية
فَ	ف
آثر	اثر
غدا،	غدا
بتغيير	تغيير
بقطار	قطار
🔴هيئة	هيئة
القياس	قياس
فﻻن	فلان
ضحيه	ضحية
هّذه	هَذِه
؛حين	حين
بخدمة	خدمة
للقانون	القانون
السفر؟	السفر
ايتها	عزيزتي
مطَر	مطر
وطاق	طاق
عضيم	عظيم
أعلا	أعلى
لدفع	دفع
لورق	ورق
منمرح	مرح
🌟قال	قال
جممال	جمال
قااموس	قاموس
سريع”	سريع
و4	و6
فيالشرق	الشرق
الحَديث	الحديث
الأسبق	السابق
اخرى،	اخرى
گلا	كلا
عدوك	العدو
نحنو	نحن
فيهآ	فيها
حققت	تحقق
كما…	كما
إيطار	إطار
الداخي	الذاتي
لك💓	لك
ميتٍ	ميت
بالمسار	المسار
اعيرو	انبرى
كلما	كلّما
كثيراا	كثيرا
لسوق	سوق
سخص	شخص
شركه	شركة
العممر	العمر
حصولهم	الحصول
سـوى	سوى
بوصات	بوصة
أينماا	أينما
،وقفت	وقفت
قصہ	قصة
عليه❤️	عليه
الحنوب	الجنوب
لوكاله	لوكالة
عبورلا	عبور
سقطوا	سقط
أقلّ	أقل
لغني	غني
بريهة	قبعة
بشارع	شارع
أغاني	أغنية
مكتوبة،لا	مكتوبة
مكتوبة،	مكتوبة
خلق…	خلق
ثانى	ثان
وحيييد	وحيد
الكثيير	الكثير
الحكم	حكم
عميق”	سحيق
له✨	له
بإسقاط	إسقاط
وفوق	فوق
اي	إي
كلمہ	كلمة
بنا،،	بنا
،بس	بسّ
مفتاااح	مفتاح
‏منذ	منذ
وِتر	وتر
نتجية	نتيجة
تجهيز	توفير
مذهل	مخيف
تكريك	تشغيل
دعوة…	دعوة
اربع	اربعة
إبن	ابن
وملكة	ملكة
اﻻساسية	الأساسية
الشتاء	شتاء
واااسع	واسع
ومثل	مثل
ميت،،	ميت
البحر	المحيط
طالمّا	طالما
النتيج	النتيجة
دقيقة…	دقيقة
كُره،	كره
مباشـــــر	مباشر
النّساء	النساء
ضُوء	ضوء
اربعة	أربعة
رهييييييب	رهيب
المتحف	المعرض
عمليّة	عملية
انا	أنا
عيييب	عيب
فﻵن	فلان
لذييييذ	لذيذ
هذَا	هَذا
شبہ	شبه
حرارھ	حرارة
مشغول…	مشغول
صفحتنا	الصفحة
وهيا	وهي
بيشتري	اشترى
البيانات	الأرقام
المحاو…	الحركة
الصحيح	السليم
الفرقه	فرقة
أقترح	اقترح
ممّن	ممن
بههم	بكما
مع…	مع
أكث…	أكثر
الأخضر	الأصفر
لأرسال	إرسال
خوفٌ	خوف
بـما	بما
الأطعمة	اللحوم
بخطر	خطر
سعيـد	سعيد
أُولئك	أولئك
حطموا	حطم
ورقيق	رقيق
ونحن	نحن
كشريط	شريط
وحيدة	وحيد
_الأثنين	البيض
،مفهوم	مفهوم
جزئ	جزء
شخصٍ	شخص
عنهكربة	كرب
الماال	المال
سجلها	سجل
؛سبحان	سبحان
ماتَ	مات
وااضح	واضح
أصبعه	إصبع
عل…	على
بيتز	كيت
الفعل،	الفعل
ربطات	ربطة
جميل💕	جميل
راائع	رائع
مقدّس،	مقدس
،أقول	أقول
ثقيله	ثقيلة
نوافذ	نافذة
،يبدو	يبدو
فِعل	فعل
جدآ	جدا
مؤكده	مؤكد
،ضمن	ضمن
واااضح	واضح
بتهمة	تهمة
مليونين	مليون
لاتنمو	تنمو
سحب…	سحب
⁰بس	بسّ
،،لكي	لكيلا
‏​بين	بين
إلذي	الذي
ورحلة	رحلة
أُسس	أسس
_لما	لما
حقيقه…	حقيقة
اياها	إياها
‏كي	كي
خﻻل	خلال
المياه”	المعادن
مخيف	مذهل
“أفضل	أفضل
بذىء	بذيء
هبً	هبّ
رااقي	راقي
مُقابل	مقابل
الأنخفاض	الارتفاع
عقوبته	عقوبة
تهجّى	تهجى
غالباً	غالبا
،غير	غير
اﻻم	الأم
نآمل	نأمل
قامت	قام
فالحشامنزل	منزل
وبذيء	بذيء
طيب؟	طيب
تعلـم	تعلم
جوابها	الجواب
فظييييع	فظيع
عليّل	عليل
صغيييير	صغير
نااااعم	ناعم
الكليه	القسم
صُبُرًا	حَبَّذَا
سماءء	سماء
،خلال	خلال
مألم	مخيف
ممتازه	ممتاز
ۆقد	وقد
،احتفظ	احتفظ
التجربہ	التجربة
التمثيل	تمثيل
مغلقة	مفتوحة
متأسفه	متأسف
فنغ	فو
مغنطيس	مغناطيس
،،لكي	لكي
مؤلم	مؤسف
6قطعه	قطن
وسبب	سبب
أغبياء؛	أولاء
رجل…	رجل
الهوة	الفجوة
خشب	الخشب
نافِذة	نافذة
الرئيسة	الرئيسية
‏لعبة	لعبة
لقياس	قياس
لربطة	ربطة
هن⬅	هن
الأخيرة…	الاخيرة
البنك؟	البنك
شغل☺	شغل
كئيب؟	كئيب
سنين	سنوات
مخزيٍ	مخز
تلائم	تناسب
بالسفر	السفر
أشجار	شجرة
رزيل	ظريف
حآلة	حالة
الخضار	الخبز
لذين	الذين
ذيلاً	ذيل
عدَّة	عدة
تسذا	كذا
عَميق	عميق
ترفع	رفع
دنئ	دنيء
لذيييذ	لذيذ
فرتب	رتب
عكسه	العكس
شكرًا	شكرا
ويكون	يكون
الرسال…	الرسالة
الأخيرة	الاخيرة
حجِم	حجم
محركات	محرك
حصل	حصلت
الثلوج،	الجليد
واين	أين
رفعوا	رفع
علی	على
‏مادة	مادة
،لم	لم
شقيقه	شقيقة
الازرق	الأزرق
​لما	لما
خُطة	خطة
بدﻻ	بدلا
صمدلم	ولم
كَأنّهَا	لَكِنَّ
ووصف	وصف
النصف	نصف
ألعاب	لعبة
فيمّا	فيما
لرصد	رصد
الخضروات	الفاكهة
_لو	لو
؛مِن	مِن
عَمَّا…	عَمَّا
إرتداء	ارتداء
سٰرعان	سرعان
المقبل”	المقبل
كمال،	كمال
رفيع،	رفيع
﴿إنَّ	إِنَّ
الأرتفاع	الارتفاع
خرئط	خريطة
حِلم	حلم
شهرين	شهر
إيقاف	توقف
لوقف	وقف
محاولة…	محاولة
🔑مفتاح	مفتاح
انتم	أنتم
لعُمر	لعمر
فستاان	فستان
“صحيح	صحيح
الذين	اللذين
وأما	أما
خاااااص	خاص
ارضٍ	أرض
كهربي	كهربائي
سعييد	سعيد
جدول	الجدول
هآئل	هائل
‏نبيل	نبيل
ماحدث	حدث
مفتااح	مفتاح
اركض	ركض
لقمةأحدكم	لقمة
معًا	معا
الفعـل	الفعل
عااام	عام
عبورٌ	عبور
وااحد	واحد
٠٠٠ولا	ولا
شاحنة	سيارة
ذلكَ	ذلك
ۈاحد	واحد
‏البعض	البعض
جيرانا	الجيران
اججل	اجل
واحد”	واحد
يؤدي	أدى
الضفدعة	الحشرة
،مِن	مِن
السآق	الساق
بعيـد	بعيد
‏​ماذا	ماذا
إمآ	إمّا
واسع،	واسع
بإيد	بيد
بالعمل	العمل
هُنا	هاهنا
‏شكل	شكل
وناعم	ناعم
اياه	إياهم
2⃣في	في
تلبيته	تلبية
للقرن	القرن
يعقتد	يعتقد
موقفه	موقف
آهل	أهل
فقره	فقرة
مظلم،	مظلم
قصائد	قصيدة
احتبار	اختبار
هذ…	هذا
غنيٌ	غني
​لم	لم
ودولة	دولة
وضييييع	وضيع
إينما	أينما
مآذآ	ماذا
مُمكن	ممكن
آثار	أثار
مهمها	مهما
،وان	وان
الكورة	كرة
معتم	مظلم
مدام	مادام
حـول	حول
اماا	اما
بيلعب	لعب
،،وان	وان
كوره	كرة
تجربة	التجربة
الحاضر،	الحاضر
طوول	طول
تطرح	طرح
صغير😂😂	صغير
مّمن	ممن
مصنوعة	مصنوع
طووووول	طول
كِلاهما	كلاهما
‏​بعض	بعض
‏​‏​عندما	عندما
العمر…	العمر
طب	طيب
حـي	حي
بالأدق	بالأحرى
ووسط	وسط
الطاقة،	الطاقة
بضعَ	بضع
الكبرى،	الكبرى
اختراع…	اختراع
تحّول	تحوّل
الخلية	خلية
بالقرب	قرب
النفس،،	النفس
ام	أم
الدخول	دخول
مؤذٍ	مؤذ
تتطلبها	تتطلب
مليون…	مليون
لديك	لديه
الكاليماري	البيض
جـدول	جدول
موكده	مؤكد
نطلب	تطلب
آميِن	آمينَ
ومهما	مهما
وقال،	وقال
سنّة	سنة
سَأنساك	تأنق
علبةة	علبة
تستدعي	تتطلب
أيضآ	أيضا
اسمر،	أسمر
والرد	الرد
اسبوع	أسبوع
وصخ	وسخ
مثآل	مثال
مخزى	مخزي
ببحيرة	بحيرة
؟بالطبع	بالطبع
لايبدو	يبدو
قبعه	قبعة
الشهير	الشهيرة
وبالتأكيد	بالطبع
طبيعية	حقيقية
لستُ	لَسْتُ
نظيف،	نظيف
طبيعي😂	طبيعي
اللغلة	اللغة
بالاحرى	بالأحرى
الضحك😂	الضحك
🔴مجموعة	مجموعة
الشاطيء	الشاطئ
گئيب	كئيب
سنه	سنة
إشعارٍ	إشعار
وحديد	حديد
محطتي	محطة
فضيله	فضيلة
المجلس	مجلس
جللٌ	جلل
هواها❤️	هواء
سيطرتة	السيطرة
لغذاء	غذاء
كُتب	كتب
الإنتاج	إنتاج
بعسير	عسير
بهآ	بها
فترات	فترة
الاول	الثالث
أياهه	إياهن
وشكل	شكل
الكلب😂	الكلب
بإرتداء	ارتداء
الولاده	الولادة
الصعب،	الصعب
أبدآ	أبدا
،فرصة	فرصة
بزياره	زيارة
الصبحي،	العشري
الام،	الأم
ممتع،	ممتع
المضبط	بالضبط
“لما	لمّا
مقدّس	مقدس
ماعرف	عرف
مثـل	مثل
‏هل	هل
الوصوول	الوصول
منحسش	نحس
ابيّض	أبيض
ملعون…	ملعون
ضحايا	ضحية
منذو	منذ
حارة	الحارة
بِها	بها
جَميل	جميل
اﻷزرق	الأزرق
وتحدث	تحدث
مشتركك	مشترك
مييل	ميل
ملايين	مليون
كمَا	كما
فتاه	فتاة
لتشغيل	تشغيل
كثيرا،	كثيرا
اكثرر	اكثر
عامّة	عامة
لمكتب	مكتب
الاهل	الجيران
اجابي	سلبي
ٺمر	تمر
حدّد	حدد
عييين	عين
_حين	حين
آلقَيُومْ	إلَيْكَ
هُنّ	هن
رجلٌ	رجل
امنه	آمنة
تجلب	جلبت
قط	قطّ
اثآر	أثار
لديهم	لدينا
فيهه	فيه
حار؟	حار
قويّ	قوي
ااثر	اثر
فُوق	فوق
خليب	حليب
يحدث…	يحدث
الدجوي	العشري
الاسبوع	الموسم
الملكيه	الملكية
فكان	وكان
يرتفع	ارتفع
اسِف	متأسف
أما	اما
إياه	إياها
حلو،	حلو
لراديو	راديو
كُرة	كرة
كذبه	كذبة
جنوني،	جنوني
وخط	خط
بابّ	باب
الحفاظ	حماية
عدّة	عدة
غذاً	غدا
يَاأيُّهَا	لَسْتُنَّ
اعداد	إعداد
رااح	راح
أبغضَ	أبغض
الاسم	اسم
آلنهر	النهر
الجنيه؟	الجنيه
سوا	سوى
عليكولستُ	اللواتي
إمرأه	امرأة
عينٍ	عين
كتيبة	فرقة
الضوء	ضوء
كلاهم	كلاهما
ادى	أدى
مُصطلح	مصطلح
كتبَ	كتب
ذلك…	ذلك
وقطن	قطن
دوائر	دائرة
بـارد	بارد
سوفا	سوف
الأسد	النظام
﴿كلا	كلا
الطائرة	طائرة
تمـر	تمر
وركن	ركن
الآول	الاول
اثبات	إثبات
تناسب…	تناسب
كلب	الكلب
بگن	بكن
يشير	تشير
تتفوق	تفوق
ومصنع	مصنع
لعينٍ	لعين
قلبَ	قلب
حسّي	حسي
الدهنيات	السكر
سفر	السفر
والسائل	السائل
مرهه	مرة
مزبووط	مضبوط
بالامس	امس
شجرةٌ	شجرة
لاتحتوي	تحتوي
العالم،	العالم
ثُم	ثمّ
وسطع	ساطع
عصابات	عصابة
جزءاً	جزء
💔وقد	وقد
حار،	حار
أُنفق	أنفق
العاصة	العاصمة
لطالما	طالما
الشاطى	الشاطئ
لأنكما	أنتما
مصلحت	مصلحة
منها…	منها
الكبرئ	الكبرى
بضبط	بالضبط
إنجار	منجز
إلی	إلى
الرعايه	الرعاية
ظهراً،	ظهرا
شقّة	شقة
لحضه	لحظة
الناس،،،	الناس
عرفَ	عرف
قرء	قرأ
عاما”	عاما
خطاب…	خطاب
أكيد	بالتأكيد
انتوا	أنتم
وثم	ثم
الأيرلندية	الملكية
دونک	دونك
أستغرقت	استغرق
عُمر	لعمر
حفره	حفرة
بشكلٍ	بشكل
استضراف	ظرافة
الاتجاه	المسار
تأهيل	تطوير
يبدأ	ابتدأ
اطار	إطار
تٌشير	تشير
ودّي	ودي
الاا	الا
،سجل	سجل
الفرح،	الفرح
حتی	حتى
اربع	بضع
ورمي	رمي
نجاج	نجاح
بماا	بما
هآؤم	هاؤم
خًط	خط
لعيين	لعين
فاضح،	فاضح
كآمل	كامل
الرجال،	الرجال
والعمل	العمل
مُثير	مثير
ممكت	ممكن
قيادة…	قيادة
استخد	استخدام
،ف	ف
حگم	حكم
بقعةٍ	بقعة
مسكيين	مسكين
الثامن	الثالث
سنة،	سنة
ضوءُ	ضوء
الماضى	الماضي
عَمَّايَعْمَلُ	عَمَّا
الطفل	طفل
هوُاء	هواء
مُوجع	موجع
آآلف	الف
اداة	أداة
مدهش	مذهل
ممآ	مما
مشرق…	مشرق
كِتاب	كتاب
الصلعة	الحشرة
وجة	وجه
كثييير	كثير
‏نظام	نظام
الاخيره	الاخيرة
قررت	تقرر
منذو	مذ
جمييل	جميل
،،عن	عن
مطار	ميناء
حسنّ	حسن
مئة	مائة
العرض98470536006677	العرض
وصرخة	صرخة
ولاكن	لكن
السير	سير
قطعةُ	قطعة
شمسّ	شمس
🔴رئيس	رئيس
بدل	بدلا
ماٺ	مات
عميييييق	عميق
التعويضات،	الرعاية
مستوفية	منفصلة
وركض	ركض
أنتُم	أنتم
الأغاني	الغناء
هالرقم	الرقم
يحرقون	حرق
جـميل	جميل
لعبو	لعب
للغاز	الغاز
كساحة	ساحة
يَعتقد	يعتقد
الخصية	الرقبة
دولة…	دولة
الحشدوالجيش	الحشد
مستويات	مستوى
ألآن	الآن
،عدا	عدا
العاشر	الثالث
مخيف	مريع
بشّع	بشع
وضيييييع	وضيع
جمااال	جمال
موقف…	موقف
الواديّ	الوادي
عااد	عاد
شِتاء	شتاء
جبل…	جبل
اناقه	أناقة
النساءمن	النساء
مخجل	مخزي
واضحه	واضح
الأمعاء،	الأنف
عيبّ	عيب
ولجلب	جلب
الكتف،	الكتف
فظٌ	فظ
آنها	انها
أياهن	إياهن
قبّعة	قبعة
الطبيتين	اللتين
عالجانب	الجانب
سيئ	رديء
سبعة	ستة
دعوَة	دعوة
وبحيرة	بحيرة
طرحه	طرح
أينما…	أينما
ممارست	ممارسة
تعلمُ	تعلم
الدابه	الحشرة
يٌحدث	يحدث
‏​عقوبة	عقوبة
رقمهم	الرقم
هاؤمُ	هاؤم
إبتدأ	ابتدأ
بحثها	البحث
اقترحت	اقترح
سَمع	سمع
مدينة…	مدينة
تسجيييييل	تسجيل
ثﻻثون	عشرون
نسختين	نسخة
مشترك،	مشترك
غيـر	غير
شگل	شكل
مياه	ماء
مفتوحه	مفتوحة
مفهموم	مفهوم
يناسب	تناسب
﴿وحيثما	إيانا
بانه	بان
،،دون	دون
كهربائي؟	كهربائي
كمأ	كما
وورقة	ورقة
قآم	قام
المدرسة…	المدرسة
شييء	شيء
الفرح…	الفرح
تفوق…	تفوق
بكم…	بكم
💕ولا	ولا
وضعنا	وضع
كلمةة	كلمة
وقآل	وقال
صخره	صخرة
طييب	طيب
،بصوت	بصوت
الضحگ	الضحك
نتائج	نتيجة
الموضووع	الموضوع
عرَف	عرف
والجنيه	الجنيه
بقعه	بقعة
سبعة	اربعة
لي🍃	لي
دونگ	دونك
ونقيب	نقيب
جمييع	جميع
فيم…	فيما
جمّال	جمال
الشهيره	الشهيرة
نجوم	نجمة
مُهيب	مهيب
وسيلة	طريقة
اختلفو	اختلف
تذكّر	تذكر
الكبر…	الكبرى
كلمّا	كلّما
متاسف	متأسف
وغضب	غضب
عميييييييق	عميق
إما	أما
معين؟	معين
منها❤️	منها
لمساعدة	مساعدة
قوّة	قوة
مُتـرف	مترف
مفاجاءة	مفاجأة
حرف👌	حرف
وبدأ	بدأ
سماوى	سماوي
رسمه	رسم
مكاتب	مكتب
دعوات	دعوة
،فقط	فقط
يُقدم	قدم
أخٍ	أخ
،إما	إمّا
عدة…	عدة
به”	به
شخصا،	شخصا
تمتيل	تمثيل
​يا	يا
ستشتعل	اشتعلت
أو…	أو
نحوا	نحو
،عن	عن
كذبة،	كذبة
الجزير	الجزيرة
ابغض	أبغض
المعلومة	الرسالة
ألذي	الذى
هذي	هذه
\/يمكن	يمكن
؟يمكن	يمكن
اذا	إذا
منطقه	منطقة
وجمع	جمع
‏حكم	حكم
خبز	الخبز
ومرفوض	مرفوض
خاصص	خاص
قي	في
خطوهـ	خطوة
مسآء	مساء
ﺎلضرورة	الضرورة
الاحد	السبت
يحفظ	حفظ
بتسجيل	تسجيل
وحساس	حساس
ملگ	ملك
باال	بال
شمالي	شمال
لفه	لفة
يائِس	يائس
الإبطين	الرقبة
وغالباً	غالبا
يحمل	تحمل
آتقان	إتقان
فاحم	لامع
السكرفي	السكر
كتبها	كتب
ذهب…	ذهب
ارتفاعات	الارتفاع
رائيسي	رئيسي
اربع	أربعة
عشرَ	عشر
مسآءء	مساء
ونقطة	نقطة
باقي	بقية
إطار	اطار
فوزه	الفوز
الشعر؟	الشعر
فماذا	ماذا
بلقمة	لقمة
إغنية	أغنية
وللشرق	الشرق
سطحِ	سطح
واسع…	واسع
الاسم	إسم
التحربه	التجربة
النار❤️	النار
ألأرض	الأرض
كاااامل	كامل
التار…	التاريخ
ملك	ملكة
عشره	عشر
الأرقام،	الأرقام
بنك	البنك
الخامسة	الثانية
لدى…	لدى
بِمن	بمن
للسباحة	السباحة
‏صور	صور
للصف	الصف
إلَيكَ❤	إلَيْكَ
إي	أي
متأسّفٍ	متأسف
لھا	لها
الرئيسية	الأساسية
مثيرتين	مثير
طبيعيه	طبيعي
أياها	إياهم
السماكة	السرعة
الجزير…	الجزيرة
فالمحيط	المحيط
راااقي	راقي
صغيـر	صغير
حيَّ	حيَّ
الضوضاء،	الضوضاء
لطِيف	لطيف
​ذيّ	ذِي
6ح	حم
حّل	حل
ااسم	اسم
كربِ	كرب
ذُو	ذو
الردّ	الرد
كثيرًا	كثيرا
هناک	هناك
بنهائي	نهائي
أمسی	أمسى
قائمة…	قائمة
دقائق	دقيقة
تستفزي	تعجبي
عقد…	عقد
،كي	كي
منحي	منح
،قطع	قطع
تغسيل	غسل
أوّل	اول
بحصة	حصة
أنظمة	نظام
وَلَلَبَسْنَا	لَسْتَ
قُبعة	قبعة
مستوا	مستوى
تطير	يطير
آلا	الا
تحمّل	تحمل
احسآس	إحساس
علامةة	علامة
الأول	الثالث
بتطوير	تطوير
له…	له
لاجل	أجل
لفتين	لفة
وعجيب	عجيب
يكُون	يكون
سريعا	بسرعة
شتآء	شتاء
إياها﴿وإن	إياهما
عصى	عصا
تعزيّز	تطوير
فتآة	فتاة
وهيّ	وهي
بعض…	بعض
اكّد	اكد
مكروه💙	مكروه
أيام	ايام
أٌرسلت	أرسلت
مخيّم	مخيم
قرييب	قريب
رطوبة	حرارة
الرجـال	الرجال
الثاني،	الثاني
زووووج	زوج
الواتي	اللواتي
بقصة	قصة
كَي	كي
ﺎلضحك	الضحك
وساطع	لامع
مطر،،	مطر
النقلة	القفزة
الكثافات	الضوضاء
،لكي	لكي
أي	إي
دعـوة	دعوة
الطبخ	طبخ
بعدة	عدة
بَالضرورة	الضرورة
عادل…	عادل
الحبّ	الحب
قديييييم	قديم
فيماا	فيما
وأضاف	واضاف
التقرير	الجدول
السميت	الخبز
وكريه	كريه
وضحية	ضحية
فضة،	فضة
؛بل	بل
سھل	سهل
أداه	أداة
​كم	كم
متآسف	متأسف
حزين”	حزين
ششبه	شبه
الرابعة	الثانية
،اثر	اثر
كإي	كأيّ
“قبل	قبل
والمعادن	المعادن
رائِحة	رائحة
كادان	كاد
السيطر…	السيطرة
الأظفر	الجذر
نحوّ	نحو
نعّم	نعم
سائحة	سيدة
يتسلق	تسلق
وتشير	تشير
يتحدث	وتحدث
اليہه	إليكما
هنآك	هنالك
والحق	الحق
غدآ	غدا
أسقاط	إسقاط
خطوةً	خطوة
نفطة	نقطة
اوشك	أوشك
بحجر	حجر
انجراف	انزلاق
‏الجلوس	الجلوس
إلئ	إلى
لك💖	لك
،،بل	بل
النتيجه	النتيجة
گتب	كتب
شيطانى	شيطاني
🎀﴿إِنَّ	إِنَّ
الجمآل	الجمال
اللذى	الذي
اختي	عزيزتي
الكبرى؟	الكبرى
محطتى	محطة
وجہ	وجه
وأين	أين
هى	هي
مُباشرة	مباشرة
الحـب	الحب
🔖فريق	فريق
أيضاميزة	ميزة
‏ماذا	ماذا
الدهون	الوزن
بمخيم	مخيم
الرسالة؟	الرسالة
مابشكل	بشكل
الورقة	ورقة
الأرض…	الأرض
مترَف	مترف
تذهبين	تذهب
شباب	الشباب
أنتن	أنتما
الخشب؟	الخشب
محموص	كتكوت
الأرضِ	الأرض
قاطعة	قاطع
جذآب	جذاب
خطّة	خطة
مصل…	مصلحة
آنتي	أنتِ
تاثير	تأثير
كيسة	كيس
لعصا	عصا
مليوون	مليون
سِوى	سوى
السااحل	الساحل
منحوووس	منحوس
يوم…	يوم
الصحافه	الصحافة
سببب	سبب
؛إما	إمّا
ولولا	لولا
أمنه	آمنة
يُحدث	يحدث
لدائرة	دائرة
اللاّتي	اللائي
تافه؟	تافه
‏راح	راح
ضعف…	ضعف
امتحان	اختبار
قتلو	قتل
الجيش	الحشد
سوآء	سواء
عامآ	عاما
هّذا	هَذا
ومناطقي	مقيت
قوه…	قوة
الفولاذي	الصلب
ثلاث	ثلاثة
يبدأ	بدأ
حُفرة	حفرة
ٺعلم	تعلم
فيمَ	فيم
آو	او
إليكم،	إليكم
عليكِ	عليك
الحارة”	الحارة
مستوی	مستوى
اعلنتي	اعلنت
اللواتى	اللواتي
هؤل…	هؤلاء
بأغنية	أغنية
شكلها	شكل
آمنةً	آمنة
الذرآع	الذراع
،ودي	ودي
مؤكد|	مؤكد
​ودي	ودي
الرجا	الرجاء
،عسى	عسى
القسم…	القسم
فيكوكب	كوكب
أيسرُ	أيسر
سحآبة	سحابة
نتيجه	نتيجة
لاتعرف	تعرف
حى	حي
النبقية	لينة
ضحاية	ضحية
تتفقان	توافق
ظہر	ظهر
سيارتي	سيارة
ويمكن	يمكن
عليه♥	عليه
هُنالك	هنالك
قِطعة	قطعة
المكوث	الجلوس
تعديل	تغيير
غير🍃	غير
مباش…	مباشرة
اﻻطفال	الأطفال
صآر	صار
تضمنين	تضمن
لصناعة	صناعة
فوزه	فوز
الكرة	كرة
ترمي	تلقي
عاااد	عاد
عسيراللهم	عسير
الﻵتي	اللائي
ضده…	ضد
الأولى	الثانية
بسببب	بسبب
حتئ	حتى
خطرعلى	خطر
الاوتوستراد	الساحل
وغني	غني
حاااار	حار
أصبحَ	أصبح
النسآء	النساء
،مادام	مادام
التاريح	التاريخ
للمسار	المسار
غريييب	غريب
عآد	عاد
الكُبرى	الكبرى
محرن	محزن
صباحًا	صباحا
نتيجة	نتاج
عجله	عجلة
آراد	أراد
آلليل	الليل
تحتاح	تحتاج
لأثبات	إثبات
شيء…	شيء
كثيرآ	كثيرا
نففس	نفس
هوﻻء	هؤلاء
وكأنّما	كأنّما
فقطالهدفإسقاط	إسقاط
لإقامة	إقامة
الصمـت	الصمت
إضاف…	إضافة
الأخضر…	الأخضر
اَللَّهَ	كَأَنَّ
بسبب…	بسبب
غالباََ	غالبا
‏​عزيزتي	عزيزتي
لجولة	جولة
مباشر…	مباشرة
سوىء	سوى
إياك	إياكم
صافق	طاق
ذِى	ذِي
ومظلم	مظلم
فحكاله	حاي
🔴موجة	موجة
بندقيتها	بندقية
خريطه	خريطة
غريب…	غريب
فَقْـــروَ	لَيْسَ
تماماً،	تماما
حيثٌ	حيث
بمآذا	بماذا
كان…	كان
منذُ	منذ
نقط…	نقطة
السادس	الثالث
أصبَح	أصبح
هناك	هنالك
كذبہ	كذبة
موضووع	موضوع
ضده	ضد
اولئلك	أولئك
ععاد	عاد
جنوووني	جنوني
بِكَلِمَةٍ	هَيْهَاتَ
أحب	أبغض
الذاتي،	الذاتي
بعيدٱ	بعيدا
حزينن	حزين
مريض،،	مكروب
الجملة	العبارة
المعارك…	المعركة
كانٺ	كانت
مطاردته	مطاردة
النساء…	النساء
بشمال	شمال
قيمة…	قيمة
حيآة	حياة
الصفين	الصف
منهآ	منها
عاااادل	عادل
شكرااا	شكرا
لكى	لكي
TABI3مباااشر	مباشرة
آسمر	أسمر
عَمَّايَعْمَلُ	عَمَّا
وحده	وحدة
بقطع	قطع
هذهي	هذه
ووحدة	وحدة
حالياَ	حاليا
قاعة	ساحة
الكلية	القسم
وراح	راح
ايّ	اي
قصيرلا	قصير
واسِع	واسع
الى	إلى
مُرعب	مرعب
معين؛	معين
تندلع	اشتعلت
شاااااااهد	شاهد
يتوقف	توقف
حليييب	حليب
،أما	أما
جوابه	الجواب
وبات	بات
نعمم	نعم
بالعالم	العالم
خطوةٍ	خطوة
ظهرت	تظهر
مكرو…	مكروه
‏غريب	غريب
اليكما	إليكما
“راقب	راقب
الخميس	السبت
أسنان،	أسنان
الرقبة	الكتف
فيهاا	فيها
بغرفة	غرفة
مساواه	مساواة
تضهر	تظهر
أيجابي	سلبي
للمدينة	المدينة
‏تذكر	تذكر
الشطائر	الخبز
عيـب	عيب
بالذهب	الذهب
ذاک	ذاك
شاهدوا	شاهد
لفقرة	فقرة
هَاؤم	هاؤم
السنجاب	القط
مااات	مات
تصاميم	تصميم
رآي	رأي
خااااااص	خاص
و8	و6
​هل	هل
نآفذة	نافذة
لنا”	لنا
صباحاً	صباحا
‏احد	احد
ذهنك	ذهني
الحصان،	الحصان
تريدين	تريد
سمعنا	سمعت
وتحت	تحت
وأدى	أدى
لموضوع	موضوع
‏ربما	ربما
ﺎرض	أرض
نُوم	نوم
الرابع	الثالث
ماات	مات
نحقق	تحقق
،مثل	مثل
حدثت	تحدث
كليهما	كلاهما
أثآر	أثار
وتحتاج	تحتاج
بمنزل	منزل
وحيد،	وحيد
أخضر	أحمر
بالصحافة	الصحافة
سوآ	سوى
آمنه	آمنة
الجحش	القط
انيق	أنيق
حسااس	حساس
جُندي	جندي
فالغابات	الغابات
احتفض	احتفظ
ومحروب	مكروب
نحتاج	تحتاج
فـِ♡ـيْه	فيه
المعهد	المعرض
بزيارة	زيارة
الرسم	رسم
‏تخيل	تخيل
جلبتمن	جلبت
رفيـع	رفيع
حزب_الله	حزب
بس	بسّ
اشعلتم	اشتعلت
ﺎجل	أجل
رخيييييص	رخيص
طبيعي،	طبيعي
فيها،	فيها
أثبات	إثبات
الإجابة	الجواب
صفقات	صفقة
صورة	صور
ومرعب	مرعب
الرسالة…	الرسالة
ﺎلنفس	النفس
اﻻزرق	الأزرق
الحرارة	حرارة
‏​ربما	ربما
إنتم	أنتم
دونه	دوني
السكر،	السكر
رأي…	رأي
ممى	مما
…كان	وكان
داعم	دعم
لسيارة	سيارة
مَعَنَالَا	لَعَلَّ
لها”	لها
\/عدم	عدم
غسلوا	غسل
مامات	مات
جمـال	جمال
للإمم	للامم
دائمآ	دائما
معين،	معين
كتب…	كتب
هؤﻻء	هؤلاء
قياة	قيادة
الاول	الثاني
بيتقلب	انقلب
،،،وقد	وقد
فااااضح	فاضح
نوم😂	نوم
لنظام	نظام
التهمة	تهمة
وعجب	عجب
وحيّد	وحيد
ألناس	الناس
،اما	أما
محطه	محطة
مريض…	مريض
وجبل	جبل
أيجابي	إيجابي
الجرس	جرس
،،فإن	فان
أوشكنا	أوشك
هؤولاء	هؤلاء
مناجم	منجم
رائع👍	رائع
مجراء	مسار
ألحديث	الحديث
العواك	العشري
ومزيج	مزيج
،دون	دون
هيّاا	هيّا
الذاتي…	الذاتي
حافةِ	حافة
،سيّد	سيد
تنمية	تطوير
منطقةالشرق	الشرق
تُقرّر	تقرر
اكتشف	اكتشاف
«يعتقد	يعتقد
بِأَنَّ	أَنَّ
أولئگ	أولئك
الغرب	الشرق
الاب	الأب
درجةة	درجة
،وقالت	وقالت
اصطلاح	مصطلح
التارخ	التاريخ
ميل،	ميل
\/تسجيل	تسجيل
الجزيره…	الجزيرة
علاء	عادل
رتّـب	رتب
أسرة	عائلة
متفوّقاً	متفوق
اسمع	سمع
وسواء	سواء
مُحزن	محزن
إي	اي
فيما	فيم
بمثلث	مثلث
وصحراء	صحراء
تعلّم	تعلم
الشاطىء	الشاطئ
“حماية	حماية
نحنٌ	نحن
عنصرا	عنصر
لمركز	مركز
اللّيل	الليل
ضوء،	ضوء
النفس…	النفس
إمتداد	امتداد
اقول	أقول
تاريخ	التاريخ
ٱنيق	أنيق
الانيق	الأنيق
يكون…	يكون
بها…	بها
يمكن…	يمكن
قلماً	قلما
گيفما	كيفما
الشعر…	الشعر
‏​يوم	يوم
الاولي	الاولى
دعوةة	دعوة
،كيف	كيف
رئي	رأي
قرأَ	قرأ
كثيرأ	كثيرا
ثمم	ثم
إليك	إليكم
الأعداء	العدو
دائماً	دائما
بضرب	ضرب
وسباق	سباق
مخجل	محزن
إثنين	اثنين
تُهمة	تهمة
“قد	قد
فيم…	فيم
يقبل	أقبل
فااااخر	فاخر
‏أنا	أنا
عليہا	عليها
​أنا	أنا
مفاجيء	مفاجئ
حااد	حاد
أربعه	أربعة
انهه	انه
حاليأ	حاليا
النظّر	النظر
محبووووب	محبوب
دونيَ	دوني
ﺑصوت	بصوت
مہما	مهما
فأصلحهاوالعالمُ	العالم
ظهرًا	ظهرا
الفف	ألف
الفرصه	فرصة
المسيقى	الموسيقى
النظام…	النظام
قديفة	قذيفة
سمعٺ	سمعت
منذ	مذ
زهره	زهرة
واحد👌	واحد
ونادر	نادر
الوحشى	وحشي
الاشعاعي	الذاتي
اللذانلا	اللذان
نهايہ	نهاية
ومتجر	متجر
تيّار	تيار
اى	اي
نتبجة	نتيجة
عااااام	عام
أشتري	اشترى
عااااد	عاد
السلوليت	الجلد
متمقلب	متفوق
ولازال	مازال
جآء	جاء
نـعم	نعم
ممتاااااز	ممتاز
لأغنية	أغنية
دم	الدم
وتـر	وتر
متمرمط	متفوق
أي	اي
سيء	تعيس
عامه	عامة
بدا	بدأ
​الجلوس	الجلوس
سمّيك	سميك
ماسمعت	سمعت
سيّئة	سيئة
الاذقية	الساحل
اللهجعل	جعل
غَفلتْ	بَسْ
وذات	ذات
تحصلت	حصلت
إنقلب	انقلب
محلكم	مكانكم
ملعونة	ملعون
،راقب	راقب
رائحه	رائحة
لطيفُ	لطيف
اسفة	أسف
تجرية	تجربة
،قول	قول
تحسي	تحسين
قصيده	قصيدة
ججنوني	جنوني
ذااك	ذاك
نغمات	نغمة
رمادي،	رمادي
محتاح	محتاج
جنونه	جنوني
صرخة	صيحة
ايضا	أيضا
كرررريه	كريه
الذىلا	الذى
مليِح	مليح
جداا	جدا
سوديلور	الجليد
سميـك	سميك
أخرى…	اخرى
مساواتهم	مساواة
صف	الصف
البيضالخميس	البيض
أستخدام	استخدام
بالقانون	القانون
حساس،	حساس
مِمّن	ممن
براديو	راديو
بدايات	بداية
امنة	آمنة
إمرأة	فتاة
‏جعل	جعل
إتجاه	تجاه
او…	او
سآطع	ساطع
ماخلا	خلا
أربع	أربعة
لاتتطلب	تتطلب
احمر	أحمر
استخدم	استخدام
مما…	مما
هاؤُمُ	هاؤم
للوصول	الوصول
لي✨	لي
مباشــر	مباشر
اكث…	اكثر
وهاكِ	هاكَ
¤ولم	ولم
‏موقف	موقف
ثلاثة	سبعة
​حين	حين
طول…	طول
الوان	لون
عدوها	العدو
،جعل	جعل
‏صورة	صور
مفهُوم	مفهوم
قارة	القارة
طرريق	طريق
أينمآ	أينما
ابازيد	العشري
عقـل	عقل
بشري،	بشري
\/قول	قول
الضحک	الضحك
التي…	التى
اﻻبتسامة	الابتسامة
إليگ	إليكَ
برمي	رمي
لماذ	لماذا
الجامعة	المدرسة
مفاجاة	مفاجأة
،كذلك	كذلك
بك	بكما
أعلى…	أعلى
مُخيف	مخيف
‏‏اذا	اذا
\/إما	إمّا
فرصه	فرصة
اسنان؟	أسنان
أنكن	أنتن
حرف…	حرف
بقتل	قتل
عالأقل	الأقل
الجبههههه	الجبهة
ليْتَ	لَيْتَ
العِظاام	العظام
نحوَ	نحو
بؤثر	متعذر
اكثثر	اكثر
‏هناك	هنالك
زيارتنا	زيارة
النسااء	النساء
الدبر﴾	الجمع
تركَ	ترك
“إن	إن
السابق\/	السابق
،أن	أن
وحلم	حلم
تقطع	قطع
حاار	حار
مطرر	مطر
بحيره	بحيرة
✌هؤلاء	أولاء
ما…	ما
\/بعض	بعض
سعيد❤️	سعيد
صخرةٍ	صخرة
لاثبات	إثبات
بسطار	حذاء
التُل	الرقيق
الجبهه	الجبهة
فاغمى	مغم
،حي	حي
ووجه	وجه
الثلج	ثلج
إليهغَفَرَ	إلَيْكَ
المهرجان	المعرض
بدايت	بداية
قلبٍ	قلب
شىء	شيء
شقيٌ	شقي
أقلته	جلبت
يدِ	يد
‏قبل	قبل
،إذا	إذا
شامل…	شامل
‏وحدة	وحدة
آخ	أخ
إنه	انه
اوراق	ورق
شااهد	شاهد
موكدة	مؤكد
لحنّ	لحن
إحتفظ	احتفظ
وهادئ	هادئ
اختيار…	اختيار
عضال،	عضال
غيرر	غير
عليك…	عليك
وممكن	ممكن
امراءة	امرأة
ﺎﻟمحيط	المحيط
“شريط”	شريط
أُم	أم
اﻻرض	الأرض
مادآم	مادام
بغرب	غرب
بسب	بسبب
القرد	القط
فعله	فعل
❗بل	بل
نااادر	نادر
اللسانيات	اللغة
إعاده	اعادة
مضبووط	مضبوط
اجمـع	أجمع
رجعناه	رجع
العگس	العكس
سمعت	سمع
قبضهصاعق	صاعق
قـد	قد
اسبوع…	أسبوع
​عزيزتي	عزيزتي
وصالح	صالح
حمايه	حماية
سيغادر	غادر
وقيمة	قيمة
لسعيد	لعمر
شهر…	شهر
“أنا	أنا
بواسط	بواسطة
لها💜	لها
لها…	لها
﴿إذ	إذ
فريقي	فريق
إيّاه	إياها
والقبيب	الوادي
تتلائم	تناسب
عسير،	عسير
كامل؟	كامل
مهماا	مهما
رديئ	رديء
تآثير	تأثير
ميل|	ميل
الشرق_	الشرق
الان☺	الان
الردعلي	العرض
ينبغيّ	ينبغي
سينقلب	انقلب
له💕	له
كككل	ككل
مرررعب	مرعب
بسرعہ	بسرعة
اكيد	اعتقد
اشعار	إشعار
ۈقال	وقال
متآمر،	مشؤوم
اعمدة	عمود
شبابنا	الشباب
هِذه	هَذِه
​​بعد	بعد
بنسخة	نسخة
ميتَ	ميت
وكيت	كيت
أماامك	أمامك
مُنعطف	منعطف
بماذآ	بماذا
تعلمـ	تعلم
أمَّا	أمّا
لجناح	جناح
نظيفه	نظيف
غير…	غير
__ف	ف
حطّم	حطم
آآه	آه
لاجل	اجل
أسود،	أسود
فظّا	فظ
التفاحه	تفاحة
وضربة	ضربة
،،ولا	ولا
قيامهم	القيام
،شكرا	شكرا
الححب	الحب
فالقرن	القرن
غداََ	غدا
معفن	عفن
“ذو	ذو
محبذ	محبب
السبب؟؟	السبب
الصحيفي	العشري
أقول…	أقول
​اكل	أكل
أناقه	أناقة
بنظام	نظام
نعمنعم	نعم
لموجة	موجة
يطرح	طرح
“لو	لو
،اختر	اختر
رااااقي	راقي
الذان	اللذان
رسالة	الرسالة
باسفل	أسفل
الرياح،	الرياح
هناكـ	هناك
حفرةٍ	حفرة
رايع	خرافي
بالصيف	الصيف
خآص	خاص
تقرحي	قرح
وقبعة	قبعة
كادت	كاد
المباركتين	اللتين
بقاعدة	قاعدة
إنما	إنّما
تآم	تام
بجمع	جمع
اداه	أداة
التي…	التي
ٺعرف	تعرف
بالحكم	الحكم
محاولتهم	محاولة
الأنف،	الأنف
اللحد�	اللتيا
كجرس	جرس
تعقد	عقدت
محتاااج	محتاج
بموقف	موقف
الاول…	الاول
يكتشف	اكتشاف
آلف	ألف
“لئن	لئن
يبدوا	يبدو
حركة	الحركة
اغنية	أغنية
اﻹبتسامة	الابتسامة
الثالثة	الثانية
مكتوبةلا	مكتوبة
أنآ	أنا
الآن،	الآن
أعلی	أعلى
الباطل	الحق
وفقير	فقير
المواد	مادة
لكم،اسمع	لكم
محموعة	مجموعة
‏اقترح	اقترح
ضوءٍ	ضوء
الجيرا…	الجيران
ااقل	أقل
آلحب	الحب
لسلسلة	سلسلة
،دقيق	دقيق
مازوخي	متوحش
وكتب	كتب
حسسب	حسب
الّذين	الذين
هنالگ	هنالك
عسير…	عسير
واحتفظ	احتفظ
متذ	منذ
معرض	المعرض
بآيخ	بايخ
فتآه	فتاة
اسرة	عائلة
لأهل	أهل
الصفحة،	الصفحة
جييد	جيد
الشوكولاتة،	الفاكهة
\/وان	وان
متقن،	متقن
الرئيسي	رئيسي
الموس…	الموسم
بسيطة،	بسيطة
التوترات	الفجوة
حصه	حصة
وتررواه	وتر
يائس،	يائس
قيمـة	قيمة
امّا	اما
طري…	طريق
وفقرة	فقرة
فنّ	فن
المئه	المائة
سهلَ	سهل
مشغوول	مشغول
بمركز	مركز
ايآم	ايام
وملك	ملك
إذًا	إذاً
وسعيد	سعيد
مِعطفُ	معطف
‏مِن	مِن
قذر	حقير
تتذكر	تذكر
هَاؤُمُ	هاؤم
اعلى…	أعلى
جميل❤	جميل
نفـس	نفس
مقع…	مقعد
٩قطع	قطن
ويقرح	قرح
صفقتين	صفقة
اثم؟	أثم
مرّوع	مروع
لقاعدة	قاعدة
جولة،	جولة
أغطية	غطاء
ايضآ	ايضا
كذاا	كذا
ثقيلہ	ثقيلة
اللائى	اللواتي
بدخول	دخول
صالحح	صالح
أمتياز	امتياز
دوُن	دون
بي،	بي
الجبل…	الجبل
وحصة	حصة
لدي	لديه
بالذهن	ذهني
الحصولعلى	الحصول
أجلِ	أجل
تجارة…	تجارة
مُنذ	منذ
،،سهل	سهل
أمامگ	أمامك
تحولت	تحوّل
رفعو	رفع
بحليب	حليب
ياعسى	عسى
مباشره	مباشرة
اﻷكسجين	الأكسجين
سبعه	سبعة
أه	آه
خُلق	خلق
تَرك	ترك
فُلان	فلان
،رجع	رجع
إنتاجها	إنتاج
‏ابن	ابن
ترغب	تريد
الغرامة	غرامة
و3	و6
آجمع	أجمع
مِعطف	معطف
صنع	صناعة
إنشاء	بناء
أذاً	إذاً
الغة	اللغة
وطريف	طريف
‏ها	ها
_وان	وان
الذي	الذى
الغِناء	الغناء
معاً♡	معا
آنتِ	أنتِ
الأخض…	الأخضر
وانتشار	انتشار
وتمثيل	تمثيل
🎪مخيم	مخيم
قلبت	انقلب
إمرأة	سيدة
مدينه	مدينة
مستوئ	مستوى
معاً	معا
عضب	غضب
مِثل	مثل
صففر	صفر
اﻷول	الاول
،نحن	نحن
اكتشافة	اختراع
عقل،	عقل
قوه	قوة
العَين	العين
“اكتب	رتب
توقّع	توقع
محطات	محطة
وقطع	قطع
الباتل…	ذواتي
عجيب،	عجيب
تجمع	جمع
ألتي	التى
الوُصول	الوصول
للحصول	الحصول
الجريحتين	اللتين
،،سواء	سواء
السوق_السوداء	الدولار
ﺎلصمت	الصمت
عليك”	عليك
ذواتى	ذواتي
⁰لو	لو
ماودي	ودي
مؤسف،	مؤسف
ورطب	رطب
،طول	طول
لطّيف	لطيف
إيام	ايام
خاااص	خاص
ممارستهم	ممارسة
تأثيره	تأثير
گما	كما
سنلبي	تلبية
وحاشى	حاشا
“حزب	حزب
_قاعدة	قاعدة
مِما	مما
هاه	ها
النفس💙	النفس
تحدد	حدد
مكتوبهـ	مكتوبة
بـي	بي
مكروهـ	مكروه
تهمةً	تهمة
هوا	هواء
لقآء	لقاء
ووضيع	وضيع
ليتوافق	متوافق
آرض	أرض
ساعتين	ساعة
آطار	اطار
ماذا	بماذا
معتاد…	معتاد
حتّى	حتى
ومازالت	وكانت
والحيلِ	الحق
بالقسم	القسم
إذن	إذاً
لكي	كي
للرياح	الرياح
حصّة	حصة
ورقةة	ورقة
هِب	هبّ
مرعب	مفزع
وكانت	كانت
مباشر	مباشرة
تخيلوا	تخيل
وسسخ	وسخ
إحتفظي	احتفظ
جدبدة	جديدة
8️⃣القصة	القدم
بِشكل	بشكل
اللتى	التى
علية	عليه
سقطَ	سقط
سعيده،،	سعيدة
هيّ	هي
كاامل	كامل
الجمعُ	الجمع
حدث…	حدث
أرسلته	أرسلت
آلشرآع	الشراع
لتي	التي
قرحه	قرح
بزيارتكن	بكن
أياً	أيا
لقطع	قطع
سرعآن	سرعان
متعقل	مبتذل
المساوة	مساواة
حدَث	حدث
اشعارٍ	إشعار
لشرع	شرع
الة	آلة
آسم	اسم
القانون…	القانون
مياشر	مباشر
رُبّ	رُبَّ
اﻻكسجين	الأكسجين
ردك	الرد
معتاد،	معتاد
‏مؤلم	مؤلم
ﺎلعمر	العمر
لحظہ	لحظة
حسسن	حسن
الشمال	الجنوب
مخز	مخزي
ستذهب	تذهب
‏آخر	آخر
لرمل	رمل
يبدُو	يبدو
‏غالباً	غالبا
مائه	مائة
المُوسيقى	الموسيقى
لگما	لكما
لحظهہ	لحظة
منه…	منها
‏رُبّ	رُبَّ
لاتحتاج	تحتاج
بكم،	بكم
نسخ	نسخة
مريض،	مريض
حُر	حر
زيارت	زيارة
بحر،	بحر
الصفحہ	الصفحة
تحتاج…	تحتاج
إلَيكَ”	إلَيْكَ
منذوا	مذ
انهاا	انها
أوريكطيب	طيب
عميق…	عميق
إختلف	اختلف
،طالما	طالما
اقتناء	شراء
الجمع،	الجمع
ذهبت	تذهب
تتشبهي	تعجبي
وين	أين
وملعون	ملعون
مناطق	منطقة
ورجع	رجع
باتبو	التل
ممارسه	ممارسة
موضوع	الموضوع
للأنباء	لوكالة
محلس	مجلس
فيديومشهد	مشهد
تستلزم	تتطلب
صـوت	صوت
رطّب	رطب
العدوّ	العدو
يالضبط	بالضبط
أنت”	أنت
خاصة…	خاصة
المثير	مثير
للأمم…	للامم
ودقيق	دقيق
ﺂلضرورة	الضرورة
بوصة،	بوصة
الثا…	الثاني
الذيّن	اللذين
أليم،	أليم
♡كلما	كلّما
وغذاء	غذاء
الخبز…	الخبز
سيئة…	سيئة
تلعب	لعب
غنى	غني
عينّ	عين
واحده	وحدة
مقدس،	مقدس
اياها	إياه
اﻷمة	الأمة
‏إِنَّ	إِنَّ
معُين	معين
ورقہ	ورقة
غريييب	عجيب
بأن	بان
الرز	الخبز
بطباعة	طباعة
مرووي	مروع
بدايةة	بداية
المصرف	البنك
“مهما	مهما
مازل	مازال
الوقت…	الوقت
هوااء	هواء
جبهة	الجبهة
الموووت	الموت
ممجوج	مريع
إشعـاراً	إشعار
محارشة	ظرافة
أو	او
فلآن	فلان
انت	أنت
حيث…	حيث
فى…	فى
لقاموس	قاموس
شهير،	شهير
ااصبح	أصبح
،،بحر	بحر
الفخد	الساق
كِلا	كلتا
وقوي	قوي
حرّ	حر
الاجابة	الجواب
وجهه	وجه
المقب	المقبل
قطاع…	قطاع
تجميع	رمي
آقبل	أقبل
كرّر	كرر
ۈقالت	وقالت
الاربعاء	السبت
،،هل	هل
وقوة	قوة
ظِل	ظلّ
كريمـ	كريم
غضّب	غضب
إثـم	أثم
وتسجيل	تسجيل
لاتعتمد	تعتمد
الاخضر	الأخضر
قـاع	قاع
،،لن	لن
️لا	لا
الأبيض	الأصفر
الإنيق	الأنيق
لحزب	حزب
آسفة	آسف
ذِيْ	ذِي
مهزوز	هزيل
صندق	صندوق
سـ	سوف
الحدي…	الحديث
بسْ	بَسْ
سيارات	سيارة
عَمَّا	عَمَّا
لذيذٌ	لذيذ
احمر…	أحمر
ميـت	ميت
بدرجة	درجة
مذو	مذ
وعين	لعين
ابتدء	ابتدأ
لذيّذ	لذيذ
الاحصائيات	الأرقام
يتحدث	تحدث
للطابق	الطابق
اما	أمّا
فيہ	فيه
إياهاقال	إياهما
ععدد	عدد
سآعة	ساعة
يووم	يوم
إياها،،﷽﴿	إياهما
أيضاا	ايضا
اعادت	اعادة
عالاقل	الأقل
لحِن	لحن
‏كلمة	كلمة
أيِّ	أيّ
الحزب	حزب
غادرنا	غادر
الحمار	الحصان
قيمہ	قيمة
المدينة…	المدينة
قريباَ	قريبا
سہولة	سهولة
شنيع	بشع
أنى	أنّى
ماذ	ماذا
خراااافي	خرافي
طريقت	طريقة
درجه	درجة
الذِين	الذين
يلمس	لمس
نقترح	اقترح
مسائاً	صباحا
الضعف	ضعف
السوق	سوق
“شهير”	شهير
يؤنب	انبرى
أمرأه	امرأة
واختيار	اختيار
ححلو	حلو
مُعين،	معين
والمتفرقة	التربة
مُقدّس	مقدس
تحدّث	تحدث
قيادته	قيادة
القفزه	القفزة
مّما	مما
وكيف	كيف
ًان	ان
الأمثل	المثالي
بذره	بذرة
،هكذا	هكذا
للأمم	للامم
حاررر	حار
عدآ	عدا
حجر…	حجر
فيها”	فيها
بمجلس	مجلس
أسسو	أسس
بآسم	باسم
لغة	اللغة
النظام”	النظام
كرييم	كريم
الأزرق	الأصفر
شجرهـ	شجرة
انتضر	انتظر
تُقرر	تقرر
أمسئ	أمسى
تموي…	تزويد
…بل	بل
وعقل	عقل
علـق	علق
بمدينة	مدينة
إقل	أقل
اختاري	اختر
رح	راح
مرا	مرة
فيديوجندي	جندي
​لن	لن
تحمِل	تحمل
أنها	انها
الرقبة،	الرقبة
تيارٍ	تيار
ركيض	ركض
زيارات	زيارة
كثيرا،،	كثيرا
قررب	قرب
جمعَ	جمع
بدلامن	بدلا
الأصلى	الأصلي
،فإن	فان
الحديثُ	الحديث
أسسسف	أسف
يومم	يوم
رآح	راح
ﺎكثر	اكثر
حصولكم	الحصول
تعرف…	تعرف
شَو	بَسْ
أنيق	رقيق
اطلب	تطلب
مدبنة	مدينة
خطّ	خط
لقمةة	لقمة
ذرة…	ذرة
👤رجل	رجل
لزوج	زوج
بلد،	بلد
أهل…	أهل
الاولى	الاخيرة
عندنا	لدينا
مبـــاشر	مباشر
هَب	هبّ
سنتين	سنوات
مخزٍ	مخزي
وكيفما	كيفما
امثر	اكثر
تأثيرها	تأثير
فإنّ	فان
الجنيه	الدولار
ومنذ	مذ
عشرين	عشرون
وحرب	حرب
،،قد	قد
النتيجة…	النتيجة
جدااا	جدا
كﻻهما	كلاهما
التعجيل	القيام
جماال	جمال
بذيئ	بذيء
الدائرة	دائرة
اضحى	أضحى
بعص	بعض
كلاهما	كليهما
فظييع	فظيع
