souve	souvent
qaue	que
tienne	mienne
allait	allaient
envrion	environ
quz	que
tfont	font
vaus	vais
groos	gros
feraient	faisaient
mtien	tien
phooto	photo
1journal	journal
ereur	erreur
aurais	aurai
seuuuule	seule
tavais	avais
semblait	semble
enviee	envie
lieux	lieu
voilaaaaa	voil
tandi	tandis
fier	fi
bleuu	bleu
apeine	peine
dabbord	abord
depuit	depuis
filz	fils
dfond	fond
absolumt	absolument
dsus	dessus
hola	hol
chosr	chose
chats	chat
merciiiii	merci
rends	rendre
enfiiiin	enfin
soies	aies
rnon	non
sents	sent
joun	journe
dasn	dans
appelait	appel
cntr	contre
surles	sur
putin	putain
portera	porte
souvant	souvent
tte	toutes
zavez	avez
slment	seulement
slt	salut
guele	gueule
peautu	peau
amr	amour
srai	serai
gardes	garde
quenous	nous
seuuuuule	seule
chuuut	chut
epaule	paule
ouay	ouias
taurait	aurait
mfont	font
premiere	derniere
#clicclac	clac
juske	jusque
seron	seront
taurai	aurai
delas	del
relatif	relative
lequelle	lesquels
mots	mot
direee	dire
tiendrai	tiens
qustion	question
rbon	bon
rappor	rapport
lerreur	erreur
rason	raison
mains	main
restais	restant
dessuuuus	dessus
scnd	seconde
vtre	votre
boulo	boulot
fait	fais
ouh	hou
1table	table
meillleur	meilleur
quui	qui
rendait	rendre
boit	bois
courd	cour
dgros	gros
slmt	seulement
aucu	aucune
boushe	bouche
coe	comme
memem	meme
differente	differentes
riiiiiien	rien
seuls	seul
qii	qui
pourraient	pourrait
boord	bord
dfleur	fleur
quil	qu
mm	meme
fasait	fait
gardent	garde
restantes	suivantes
suites	suite
aviez	avez
avait	ait
osn	son
saigneur	seigneur
meuilleur	meilleur
navez	avez
#client	client
foooooort	fort
cettz	cet
semaie	semaine
aue	que
sentiez	seriez
qestion	question
millions	million
ditent	dite
photos	photo
tuture	voiture
aiee	aie
quooi	quoi
#pays	pays
pleeeeins	plein
plans	plan
lequelle	laquelle
mnde	monde
parlee	parler
arbres	arbre
envit	envie
nouit	nuit
pointde	point
nulles	nul
ord	ordre
suiis	suis
soufrent	furent
pareils	pareil
cmm	comme
geule	gueule
situations	situation
pasage	passage
#hue	hue
troublant	touchant
serez	seriez
allooo	allo
pasd	pas
possi	possible
jusque	jusqu
suuuuper	super
riiiiien	rien
geulle	gueule
_toc	toc
places	place
quma	ma
ait	avait
exept	except
intant	instant
journer	journe
vivions	tions
derier	derriere
tiendras	tiens
souuus	sous
tais	tait
faiq	fais
gagneraient	seraient
noooon	non
permettrai	permet
sentirais	sens
sont	soient
toujour	toujours
gebs	gens
tts	toutes
dix	six
compri	compris
douw	doux
serrai	serai
tranquillement	tranquille
quell	quel
prte	porte
oufff	ouf
eglise	glise
sois	soit
teeeellement	tellement
maisons	maison
riiiien	rien
raisooon	raison
lgtps	longtemps
aucn	aucuns
compar	comparable
tient	tiens
pandant	pendant
sentiez	serez
danns	dans
gro	gros
maintenat	maintenant
accause	cause
biennn	bien
etrr	etre
lesquelle	lesquelles
peune	peine
pauvr	pauvre
possib	possible
desssus	dessus
cella	cel
etait	etant
tait	ait
svnt	souvent
lieue	lieu
groupuscule	groupe
abor	abord
naturelle	naturel
qel	quelle
encie	envie
rtu	tu
apres	aprs
couranr	courant
peuples	peuple
tellment	tellement
tooous	tous
moooi	moi
lepoque	poque
arbuste	arbre
cielil	ciel
pus	pu
prendriez	seriez
aideras	aide
eut	eu
couleurs	couleur
etat	tat
souvnir	souvenir
nbreux	nombreux
luui	lui
ait	tait
lorque	lorsque
totue	toute
rne	ne
mtiens	tien
chveux	cheveu
voilaa	voil
soeure	soeur
ballon	balle
osaient	allaient
etres	etre
vzis	vais
dfamille	famille
forcez	force
nveaux	nouveaux
pkus	plus
comptr	compte
cettr	cette
seuul	seul
jr	jour
gnr	genre
campement	camp
tauras	auras
soit	soient
cett	cette
etiez	etes
foooort	fort
tent	tente
enviie	envie
oeux	peux
tiennes	tienne
netes	etes
quellle	quelle
habitaient	taient
suoi	quoi
appele	appel
iln	il
seras	serai
aurrais	aurait
cheffe	chef
etair	tait
iez	seriez
foid	fois
peeut	peut
nuuul	nul
prle	parle
prquoi	pourquoi
peuuuur	peur
intrigante	trange
1signe	signe
musi	musique
teel	tel
putzin	putain
entiers	entier
signer	signe
#prince	prince
insant	instant
soirr	soir
rendais	rend
airais	aurais
sourrire	sourire
merciiiiiii	merci
eut	eus
reste	restent
totu	tout
peiine	peine
entrein	train
sign	signe
cousin	copain
avez	ayez
ferrait	fait
coment	comment
seour	soeur
droits	droit
jrn	journe
pqs	pas
voilou	voil
pouvais	pouvait
lhistoire	histoire
appres	aprs
auriez	aviez
facil	facile
euuux	eux
enfiiiiiin	enfin
queel	quel
milion	million
quanf	quant
papaaaaa	papa
sente	sent
pendants	pendant
geul	gueule
lesquelles	laquelle
ttes	toutes
musik	musique
auw	aux
boie	bois
pdnt	pendant
encien	ancien
vooix	voix
fait	ft
entie	entier
dise	dire
avaus	avais
groupes	groupe
possible	probable
jambes	jambe
dzs	des
woua	pouah
qund	quant
jsois	sois
doeuil	oeil
fifille	fille
zute	zut
_sans	sans
mouvant	touchant
veritey	vrit
mooooort	mort
certainne	certaine
ptn	putain
ches	chez
avooir	avoir
airais	aurai
accoooord	accord
cheve	cheveu
ilne	il
aprer	aprs
qund	quand
paaf	paf
desquelles	desquels
chse	chose
particuliers	particulier
moooon	mon
marchera	marche
parreil	pareil
gesticulant	etant
ssur	sur
hens	gens
touchante	touchant
stooop	stop
aprzs	aprs
#sans	sans
policier	police
diire	dire
hor	hors
lyi	lui
dnc	donc
chaambre	chambre
dsns	ds
zoli	joli
semaaine	semaine
maaaais	mais
escalators	escalier
serra	seras
jnte	te
rnvie	envie
pouvaient	peuvent
aiderais	aide
firent	eurent
parmit	parmi
devait	devra
soient	sont
fzit	ft
soldate	soldat
ltrou	trou
#retard	retard
doits	doigt
dehord	dehors
couurs	cours
claires	clair
rieen	rien
faitez	faites
chers	cher
avai	avait
tentait	tente
desus	dessus
lmois	mois
voys	vous
courd	cours
quznd	quand
hauts	haut
cooooorps	corps
bessoin	besoin
nouvau	nouveau
tient	tien
depuiis	depuis
diiire	dire
nouq	nous
certainne	certaines
aurons	auront
froooooid	froid
fassent	faisaient
paine	peine
laquel	lesquelles
cet	cette
absoluement	absolument
fias	fais
ldroit	droit
ctai	ct
_je	je
ceuw	ceux
vingtaine	cinquantaine
parlaient	parlent
qe	que
aurez	auriez
bouillonnement	mouvement
taa	ta
lesquels	quels
denier	dernier
difficile	facile
heu	euh
robes	robe
revoirs	revoir
chancun	chacune
rapoort	rapport
gard	garde
plaisire	plaisir
nui	nuit
bisarre	bizarre
aucunes	aucune
pensr	pense
ellle	elle
nos	vos
fillle	fille
maladeeee	malade
continuelle	telle
semblais	semble
mercie	merci
maitree	matre
plusieures	plusieurs
remarchera	marche
restons	soyons
chakun	chacun
devrais	devrait
depusi	depuis
existantes	suivantes
regards	regard
blancs	blanc
faisait	faisaient
importan	important
huits	huit
ca	cela
tienn	tienne
pendnat	pendant
doutes	doute
cheuveux	cheveu
danq	dans
autres	autrui
piire	pire
ballll	balle
particulie	particulier
aau	au
amoour	amour
permette	permet
suuuuite	suite
eprouvent	eurent
serions	tions
nulle	nul
etent	etes
exact	exactement
raizon	raison
onts	ont
tooute	toute
letrre	lettre
#boisd	bois
etions	serions
journnee	journe
drniere	derniere
auxquelles	auxquels
certaine	certain
devaient	doivent
photot	photo
momeent	moment
cinetique	specifique
soiir	soire
troud	trou
alons	allons
envii	envie
tendit	tend
imag	image
probabilit	probable
retars	retard
sn	son
px	peux
envis	envie
rendaient	rend
restes	reste
tacs	tac
een	en
plud	plus
los	las
etiez	tiez
maladee	malade
envert	envers
gossitude	gosse
sns	sans
pa	pas
mien	mienne
poue	pour
sourires	sourire
auquelle	auxquelles
notre	ntre
saale	sale
auquels	auxquels
revoila	revoil
aiderons	aide
avaient	ayant
tient	tienne
pareille	pareil
1pays	pays
qulle	laquelle
sentait	sent
jserais	serais
traversera	travers
temsp	temps
sooir	soir
amoooour	amour
tiennes	miennes
foit	fois
foiiiis	fois
mvmt	mouvement
baaaat	bat
blan	blanc
certain	certains
millier	million
debuut	dbut
trein	train
conbien	combien
etrre	etre
cmnt	comment
seize	treize
#prix	prix
claasse	classe
vos	nos
amouuuuuur	amour
lsang	sang
impresion	impression
dfaux	faux
poind	point
appell	appel
nouveux	nouveaux
agnes	anne
#gouvernement	gouvernement
bh	bah
journne	journe
nuuit	nuit
lsait	sait
dames	dame
tocc	toc
peinne	peine
avit	ait
garderait	garde
persoonne	personne
copine	copain
pareeeil	pareil
autres	autre
grv	grave
quoiiii	quoi
chemiiiin	chemin
ouverts	ouverte
beaaaaau	beau
ooui	ouias
gontil	gentil
contente	content
paroles	parole
egal	egale
semblerais	semble
dedanset	dedans
aurras	auras
#peau	peau
tiens	tienne
kestion	question
tendais	tend
tiendras	tenir
pfff	pff
pars	part
lrs	leurs
passages	passage
_on	on
toujouuurs	toujours
oreil	oreille
faaaim	faim
clairs	clair
lescalier	escalier
toute	toutes
merdee	merde
dssou	dessous
impore	importe
uun	un
miens	sien
plaizz	plaisir
aurra	auras
soiiiir	soir
lequelle	lesquelles
derierre	derriere
touute	tte
nsait	sait
mooooonde	monde
votres	autres
excepter	except
laffaire	affaire
garderais	garde
fortt	fort
allei	all
appelles	appel
grve	grave
ouaos	ouias
stoooop	stop
accors	accord
qjme	me
coooorps	corps
raiso	raison
serrai	serais
dnt	dont
diirect	directe
couo	coup
devras	devra
snt	sont
serait	serai
leures	leurs
plaisiiir	plaisir
faisait	fait
jouli	joli
elel	elle
min	minute
signera	signe
taaant	tant
limpression	impression
toutnous	nous
mes	tes
essaie	essai
dessou	dessous
aieeee	aie
jolie	joli
vooooir	revoir
bn	bon
foiset	fois
marrier	mari
les	ces
princes	prince
hoo	ho
heuuuuure	heure
couraaant	courant
aurrai	aurais
fessaient	faisaient
unr	une
etaient	seraient
ait	aient
dps	depuis
pleins	plein
cmbien	combien
sais	sait
erreu	erreur
leir	leur
faitent	faites
voilla	voil
suivent	suit
#livre	livre
dnotre	ntre
imorte	importe
taaaant	tant
impote	importe
commt	comment
parlera	parle
voirs	revoir
soies	soit
tenais	tiens
voi	voie
soient	soit
genti	gentil
fichtrement	strictement
quels	lesquels
boujour	bonjour
luuui	lui
iraient	allaient
miennes	mien
dcoup	coup
malgrer	malgre
genstes	gens
afaire	affaire
cpte	compte
bonjouuuur	bonjour
tooooout	tout
lontemps	longtemps
auraient	avaient
faaim	faim
celleux	celles
nan	non
soyer	soyez
lautre	autre
rapports	rapport
instan	instant
livres	livre
suuis	suis
cher	chers
tempq	temps
souvenirs	souvenir
equiipe	quipe
dedan	dedans
huij	hui
hoppp	hop
pandant	durant
rsans	sans
looooong	long
serais	serait
touute	toute
retatd	retard
siens	sien
chaaaat	chat
leq	les
semain	semaine
acord	accord
etla	la
apelle	appel
agente	agent
rendra	rend
courons	soyons
aucu	aucun
lgenre	genre
treeees	tres
dautre	autre
cusine	cuisine
duu	du
instand	instant
jardins	jardin
heur	heure
fiss	fils
aurions	auraient
iels	elles
zouli	joli
uen	une
sentirait	sent
pourkoi	pourquoi
faais	fais
maladeee	malade
pauuuvre	pauvre
quy	qu
fsant	faisant
1millions	million
gesn	gens
avoire	avoir
oon	on
son	ton
dtes	tes
dtoute	tte
huui	hui
nonn	non
zont	ont
fesaient	faisaient
tiens	tien
#caf	caf
trux	truc
polic	police
dirre	dire
avz	aviez
personnne	personne
portait	porte
personnnes	personnes
oreille	oeil
mien	miennes
secrer	secret
portes	porte
estait	est
bonnement	absolument
miennes	siennes
choses	chose
ds	dans
soleeeil	soleil
nuuuuuuit	nuit
tendis	tandis
soir	soire
vtr	vtre
fnt	font
avaient	aient
seraient	serait
enviiiie	envie
entte	entre
seuleument	seulement
phot	photo
revoire	revoir
jgarde	garde
avaais	avais
qje	que
uncle	oncle
chmin	chemin
lesquelle	lequel
treees	tres
ordr	ordre
pences	pense
avont	ont
vivement	vive
alorq	alors
bisard	bizarre
erreurs	erreur
segonde	seconde
impossibles	impossible
tjrs	toujours
xdle	le
seulle	seule
valeure	valeur
fzit	fait
ocune	aucune
queelle	quel
quu	qui
beauu	beau
quon	on
apret	aprs
quiquonque	quiconque
longs	long
tiien	tien
touuuus	tous
froiid	froid
chalbre	chambre
partit	partie
ocun	aucun
nn	non
lettr	lettre
certainnes	certaine
mettions	tions
oour	pour
marri	mari
voous	vous
dejz	deja
coins	coin
airai	aurais
treize	seize
auncun	aucuns
parlez	parlent
avait	avaient
retrd	retard
davoir	avoir
soirer	soire
douuux	doux
trs	tres
bieen	bien
argen	argent
devraient	devrait
seigneure	seigneur
nuiiit	nuit
eus	eue
sentais	sent
voudrait	pourrait
ahh	ah
claiiir	clair
quans	quand
dessous	sous
ambitieuses	nombreuses
chaqu	chaque
parleraient	parlent
quj	qu
partait	part
etr	etre
heeure	heure
alloooo	allo
fauuuuux	faux
vouz	vous
endroits	endroit
voitu	voiture
troue	trou
direkt	directe
click	clic
aidera	aide
rapor	rapport
retar	retard
miens	mien
aillez	aviez
risquaient	faisaient
moux	doux
planete	plan
dejaaaa	deja
alloh	allo
bizard	bizarre
toooout	tout
segneur	seigneur
chuuuuuut	chut
dleurs	leur
mien	sien
parles	parlent
ennemie	ennemi
verraient	voient
avc	avec
eusses	eusse
soirrrr	soir
bords	bord
seuke	seule
tlmnt	tellement
voilas	voil
fnetre	fentre
traversa	travers
ouvre	ouverte
ild	ils
miens	miennes
beucoup	beaucoup
1petit	petit
4en	en
auquel	auxquelles
ss	sous
lls	ils
moyem	moyen
cella	celle
minut	minute
tempd	temps
jsq	jusqu
chemain	chemin
sentime	sentiment
#agent	agent
milliard	million
assumeras	auras
pieds	pied
planette	plan
ieu	dieu
doit	doivent
noueaux	nouveaux
rnous	nous
serai	serait
quelles	quels
nuuuit	nuit
truuc	truc
uin	un
essaye	essai
autreme	autrement
#chef	chef
montraient	voient
orteille	oreille
5millions	million
devoir	pouvoir
largent	argent
seulment	seulement
pffff	pff
moort	mort
fooooond	fond
cmment	comment
differente	different
prcq	parce
froiiid	froid
aurait	aurais
bravooooo	bravo
faite	faites
ecole	cole
#triste	triste
mondee	monde
croyable	comparable
leus	leurs
mojns	moins
instent	instant
moyent	moyen
tel	telle
precisent	eussent
suffira	suffit
personne	personnes
arrivaient	allaient
asser	assez
enfiin	enfin
jrnee	journe
dzns	dans
neufs	neuf
deda	dedans
houst	ouste
parts	part
cartes	carte
rendrais	rend
ver	vers
famile	famille
ezt	est
eus	eu
chevale	cheval
direct	directement
puuuure	pure
bizzard	bizarre
optimale	minimale
bonjouuur	bonjour
viv	vive
lesquel	lesquels
#dieu	dieu
quatier	quartier
comote	compte
armes	arme
quanf	quand
pxtain	putain
#maison	maison
cme	comme
teeeeellement	tellement
moiyen	moyen
serrez	serez
lesquel	lequel
beeau	beau
dieux	dieu
assumeront	auront
allet	all
votrz	votre
importante	important
qie	que
intelligentes	naturelles
phto	photo
parmis	parmi
ennemis	ennemi
meeeme	meme
appelle	appel
tmps	temps
comptes	compte
fauuuux	faux
maintement	exactement
quelle	quelles
suuuper	super
plien	plein
teeellement	tellement
ciels	ciel
auncun	aucun
aurait	avait
chacun	chacune
auquelles	auxquels
cbien	combien
ldos	dos
paln	plan
soire	soir
jpouvais	pouvait
redites	dite
plei	plein
orreille	oreille
meeeerde	merde
proffesseur	professeur
dis	dit
directement	directe
lont	ont
maa	ma
tende	tend
plasir	plaisir
heures	heure
nitre	notre
pleiiiiins	plein
dchez	chez
as	aies
dtte	tte
touuuut	tout
sjr	sur
chiens	chien
feront	font
mamoune	maman
retours	retour
devait	devrait
bonnn	bon
captaine	capitaine
savait	sait
teop	trop
mamn	maman
chooose	chose
salles	salle
silenc	silence
inpression	impression
mooon	mon
saans	sans
tjours	toujours
seulemnt	seulement
tenai	tien
directe	directement
mtien	tiens
rose	rouge
pendent	pendant
genr	genre
tr	trs
plrs	plusieurs
amouur	amour
laquelle	lesquels
#droit	droit
ssus	dessus
va	vas
aveez	aviez
jpense	pense
sobt	sont
accooooord	accord
1nouveau	nouveau
permettent	permet
sien	miens
zlle	elle
momen	moment
formes	forme
couuuuuurs	cours
propo	propos
avons	aurions
tienne	sienne
aujoird	aujourd
avrc	avec
cfils	fils
soldats	soldat
trs	tre
#avis	avis
#retour	retour
peux	peut
bizare	bizarre
cgenre	genre
ouuf	ouf
marier	mari
commr	comme
hist	histoire
petits	petit
chanse	chance
nbrses	nombreuses
doeil	oeil
chanche	chance
heinnn	hein
pedant	durant
toiiii	toi
seuk	seul
jusqua	jusque
aimeras	auras
ouste	oust
serai	serais
battre	bat
diiiit	dit
#avion	avion
marrie	mari
natel	tel
treeeees	tres
ayiez	avez
bsoin	besoin
chicha	chiche
ajourd	aujourd
meeeeeme	meme
verront	voient
faisais	fais
ba	bah
sjt	sujet
lekel	lequel
qye	que
toujourd	toujours
dnas	dans
ssuis	suis
retout	retour
chaaance	chance
epice	pice
couleu	couleur
pouvaient	pouvait
lls	elles
chaque	chacune
interieur	exterieur
ssa	sa
secet	secret
qaund	quand
aurait	auraient
aujoud	aujourd
mercii	merci
enfan	enfant
#vent	vent
mrendre	rendre
#outre	outre
persne	prs
attendue	attendu
serrons	serons
fleurs	fleur
nse	se
telefilm	film
aient	auraient
peeeeur	peur
couurs	cour
avez	aviez
alllo	allo
rendent	rendre
autoroute	route
heein	hein
ellles	elles
auxquels	auquel
avor	avoir
dpieds	pied
avions	avion
aurat	auras
dand	dans
sera	seras
aillant	ayant
accooord	accord
rembourserons	serons
plin	plein
aident	aide
genrr	genre
goupe	groupe
stoooooop	stop
clics	clic
mienne	sienne
poin	point
ses	ces
ketru	truc
hm	hum
chances	chance
soient	seraient
cter	ct
bha	bah
agents	agent
gestes	geste
lodeur	odeur
rapprt	rapport
derri	derriere
importants	important
malaaade	malade
faiis	fais
treees	trs
aaux	aux
capitain	capitaine
esr	est
truuuuc	truc
mines	mine
leuur	leur
aiderai	aide
auraient	aient
dessue	dessus
prochaine	prochain
avons	ayons
trankil	tranquille
aurions	aurait
vilage	village
ptin	putain
peuve	peuvent
abors	abord
auu	au
5personnes	personnes
_le	le
traver	travers
navez	aviez
lgtp	longtemps
conre	contre
eeeh	eh
allez	all
odre	ordre
conten	content
mmt	moment
jetais	tais
navons	aurons
amoure	amour
perssonne	personne
plsrs	plusieurs
proches	proche
suivaient	suit
voos	vos
sinan	sinon
boooon	bon
amooour	amour
puuuuure	pure
disez	dite
brrrr	brrr
aprer	apres
enfants	enfant
laissaient	faisaient
cheeeeer	cher
tice	tic
jaurais	aurai
kontre	contre
seras	serais
mooi	moi
aviez	avaient
#bravo	bravo
avait	avais
erreure	erreur
policiers	police
saait	sait
ouverteee	ouverte
dnotre	notre
prsn	prs
rendr	rendre
pensse	pense
chambres	chambre
restent	restant
touuuuuut	tout
soleils	soleil
rieeeen	rien
elke	elle
trente	treize
binne	bonne
permets	permet
senti	sens
signes	signe
dterre	terre
placele	place
auquelle	auxquels
recu	eu
serais	sera
posible	possible
suiq	suis
ein	hein
#pierre	pierre
tes	mes
laquel	lesquels
aurions	avons
cherr	cher
comle	comme
faisez	faites
chque	chaque
cellui	celui
etions	tions
tandit	tandis
paren	parent
coups	coup
aura	auras
cela	cel
vider	vide
mpn	mon
hsitoire	histoire
auquel	auxquels
gents	gens
soies	sois
devaient	allaient
nveau	nouveau
bats	bat
msieur	monsieur
malgres	malgr
soiree	soir
tenons	tiens
coumme	comme
escalator	escalier
allr	all
auxquels	auxquelles
iks	ils
aurions	auriez
hooo	ho
pleeeeeins	plein
#paix	paix
piiiire	pire
dees	des
pronce	prince
imprte	importe
simples	simple
tres	tre
aucuuuune	aucune
naturels	naturel
clas	classe
peuuur	peur
diiiiire	dire
ont	auront
jettant	tenant
#argent	argent
gardera	garde
dc	donc
claire	clair
qlques	quelques
avoi	avoir
auxquelles	auquel
ddans	dedans
tendent	tend
semaone	semaine
fassent	feront
gaars	gars
rmon	mon
diferent	different
essayais	essai
aucunne	aucune
auquelle	auquel
naturelles	naturelle
malaaaade	malade
permettra	permet
meileur	meilleur
foorme	forme
meilleure	meilleur
certai	certains
morrt	mort
particuli	particulier
dpuis	depuis
differen	different
baballe	balle
cauz	cause
douxxx	doux
orteil	oeil
celles	celle
toutz	toute
routes	route
meilleir	meilleur
comte	compte
coour	cour
moii	moi
tenu	tenir
auront	aurons
pr	pre
partit	partant
qqles	quelques
enfiiiiin	enfin
eelle	elle
direeeect	directe
oseriez	auriez
chaqun	chacune
lesquels	lesquelles
chz	chez
psser	pass
tienne	tiennes
boonne	bonne
indirectement	directement
oiseaux	oiseau
ouvertes	ouverte
moement	moment
faisiez	faites
dela	del
chey	chez
foooooond	fond
maiq	mais
bravooo	bravo
pleeeein	plein
haaa	ha
certainnes	certaines
sens	sent
pitit	petit
jsuis	suis
resterait	reste
celle	celles
haute	haut
aucu	aucuns
villag	village
au	aux
jaurais	aurais
peuuuuuur	peur
meilleu	meilleur
serrait	serait
trmps	temps
mzis	mais
tput	tout
paauvre	pauvre
dait	fait
pqoi	pourquoi
baaah	bah
1mois	mois
jusquau	jusqu
jpourrais	pourrais
avai	avais
etree	etre
votr	votre
serai	sera
rendait	rend
pareilll	pareil
serais	seras
yne	une
quel	quelle
fauuux	faux
qoi	quoi
dsang	sang
pauvreee	pauvre
geenre	genre
quelle	quel
aurez	avez
ces	ses
pourras	pourrais
momnt	moment
orai	aurai
sufit	suffit
placeeee	place
jouuur	jour
bouuum	boum
auxun	aucun
disait	dit
etions	serons
auront	ont
mdame	madame
miennes	miens
peuur	peur
sent	sens
recut	eut
beaau	beau
vtre	ntre
precisemment	precisement
etez	etes
#service	service
prce	parce
dernie	dernier
lql	lequel
effets	effet
claaaair	clair
#dollar	dollar
ctrou	trou
ceu	ceux
pein	peine
wouah	pouah
fooort	fort
#hors	hors
2ma	ma
chauud	chaud
pesonne	personne
mon	ton
euh	eh
suffirait	suffit
restait	reste
putaaaain	putain
euux	eux
libraire	livre
bebe	bb
alirs	alors
baah	bah
voilaaaa	voil
rdes	des
fesant	faisant
1plan	plan
quel	quels
bisare	bizarre
brr	brrr
looong	long
causse	cause
avais	avait
voud	vous
pouvait	pourrait
chere	cher
enversl	envers
parle	parlent
videeee	vide
seront	seraient
etrange	trange
monseigneur	monsieur
certaiine	certaine
paar	par
peure	peur
regardes	regard
bieeeeeen	bien
laql	laquelle
cmpte	compte
passer	pass
serons	seront
aurrai	aurai
prsonne	personne
foond	fond
maximale	minimale
pluq	plus
telement	tellement
dirr	dire
tellemnt	tellement
putaain	putain
ctr	contre
anciens	ancien
sanns	sans
lesuns	uns
fooooort	fort
chosee	chose
sallee	salle
cton	ton
chacunes	chacune
depice	pice
sooeur	soeur
espri	esprit
appres	apres
ohh	oh
morts	mort
dois	doit
bizar	bizarre
wouaah	pouah
vouq	vous
4dents	dent
serrais	serai
balnc	blanc
auraient	aurait
xdmais	mais
gche	gauche
impeu	peu
dleur	leur
sr	sur
estpas	est
celuis	celui
ptits	petit
zetes	etes
piree	pire
pluuuuuus	plus
plce	place
lequelle	lequel
voir	revoir
qstion	question
jvais	vais
brui	bruit
cheuveu	cheveu
environs	environ
sevice	service
boush	bouche
remari	mari
lesquelle	lesquels
mem	meme
acec	avec
froooid	froid
temos	temps
chaance	chance
dpui	depuis
troooop	trop
evier	escalier
colonnel	colonel
aucune	aucuns
#tic	tic
ouuuuf	ouf
contend	content
valeurs	valeur
ettre	tre
malgres	malgre
douuuux	doux
ouuuf	ouf
voici	voil
pourait	pourrait
hin	hein
tpus	ts
cment	comment
nouveu	nouveau
parle	parler
unz	une
chefs	chef
ptain	putain
mondeeee	monde
strou	trou
sentiez	tiez
authentique	unique
quels	quel
soirr	soire
retards	retard
ddes	des
raisons	raison
naturel	naturelle
journee	journe
marchais	marche
restais	reste
quoo	quoi
dssu	dessus
quatorze	quatre
srais	serais
permettait	permet
serrais	seras
verts	vert
ouff	ouf
confirmant	concernant
malgrer	malgr
habitud	habitude
qlqs	quelques
tannnnt	tant
aaas	as
etrz	etre
touuuute	toute
cmpris	compris
ayiez	auriez
questi	question
ironiquement	directement
lesquel	lesquelles
fnetr	fentre
gardez	garde
auhourd	aujourd
vai	vais
luo	lui
minde	monde
chanbre	chambre
premie	premier
graaaaaave	grave
recroiser	revoir
persnn	prs
avce	avec
etaient	taient
cntre	contre
humm	hum
tenire	tenir
duquel	auquel
peronnes	personnes
tien	sien
secre	secret
lsujet	sujet
soyon	soyons
mauvaise	mauvais
fis	fils
avaient	auraient
voitures	voiture
parti	partie
bort	bord
auquelles	auquel
esy	est
souvenirr	souvenir
nuls	nul
eut	eue
apr	aprs
nouveaux	nouveau
suffise	suffit
cheez	chez
lbois	bois
commme	comme
meem	meme
chuut	chut
ilq	ils
ressorte	sorte
serra	sera
brrrrrrr	brrr
suiiite	suite
cheres	cher
merciiiiii	merci
bonnne	bonne
#vive	vive
olus	plus
qumes	mes
dsuite	suite
situati	situation
quetion	question
centaine	cinquantaine
rtard	retard
piere	pierre
endroi	endroit
eu	eut
serrais	serais
moyens	moyen
rappo	rapport
foiq	fois
jontil	gentil
permettre	permet
tendant	tend
mondr	monde
couuuuurs	cour
loooong	long
ptit	petit
avoiir	avoir
particuler	particulier
dacord	accord
quetu	que
celons	selon
voiiiix	voix
gar	gars
reregarder	regard
mtiens	tiens
mdrmais	mais
lprince	prince
serat	sera
chuuuuut	chut
quitterons	aurons
euhhh	euh
cpt	compte
reste	restant
points	point
deuis	depuis
fooond	fond
#guerre	guerre
certe	certes
escaliers	escalier
carde	carte
tans	tant
chuuuuute	chut
chise	chose
situat	situation
pcqils	ils
porterais	porte
mooort	mort
tooooi	toi
marriage	mariage
rapproch	proche
pluuuus	plus
sentaient	sent
voyaient	voient
suffi	suffit
nooon	non
professeure	professeur
seraient	seront
nuiit	nuit
diieu	dieu
ms	mais
dpapier	papier
orsque	lorsque
histore	histoire
seule	seul
zst	est
trc	truc
meeeeme	meme
loooongtemps	longtemps
autr	autre
ppur	pour
boive	bois
troooooop	trop
pireeee	pire
sonr	sont
aieee	aie
cartede	carte
vus	vu
ls	les
portai	porte
dja	deja
femmes	femme
group	groupe
cettre	cet
mor	mort
_se	se
ntre	notre
tien	tiennes
piff	pif
gueuleeee	gueule
passent	pass
taaa	ta
quoooooi	quoi
dns	ds
malgr	malgre
auras	aura
jvai	vais
aurrais	aurai
beauuuu	beau
suiiiiis	suis
drooit	droit
daccord	accord
moooot	mot
#affaire	affaire
lmonde	monde
#campd	camp
suuuis	suis
prsne	prs
diiiirect	directe
vif	vifs
claair	clair
_tu	tu
graaave	grave
seriez	serez
derniers	dernier
pouquoi	pourquoi
allee	all
papaaaa	papa
toute	tte
parl	parle
poyr	pour
pann	pan
srais	serai
touuuuuute	toute
frooid	froid
faaait	fait
parties	partie
aveez	avez
pvoir	pouvoir
amouuur	amour
froiiiid	froid
pndnt	pendant
teuc	truc
plys	plus
chaaque	chaque
journeee	journe
partance	partant
permettront	permet
touuutes	toutes
faimmm	faim
dvotre	vtre
moooooort	mort
#vinrare	rare
rendrai	rendre
mpression	impression
abbord	abord
pti	petit
pzut	peut
badaboum	boum
amouuuuur	amour
madame	mme
doient	doivent
tred	tre
corp	corps
laseule	seule
eqt	est
aurai	aurais
kmes	mes
impirte	importe
parte	part
cmmnt	comment
music	musique
tous	ts
foiiis	fois
rarissime	rare
nule	nul
aviez	auriez
impressi	impression
enfinn	enfin
trooooop	trop
jourr	jour
sentai	sent
cauze	cause
avaient	avait
cooin	coin
exem	exemple
auccun	aucun
sinn	sinon
nouvo	nouveau
laquel	laquelle
rendant	rendre
habord	abord
maximal	maximale
bonnnn	bon
vecurent	eurent
mienne	mien
deq	des
oar	par
relatent	semblaient
piur	pour
beauuu	beau
qnd	quand
cours	cour
notre	votre
ouaus	ouias
chanceeeee	chance
six	dix
#peuple	peuple
contents	content
interessants	differents
mon	son
serras	seras
1jour	jour
doive	doit
rieeeeen	rien
dssus	dessus
hallo	allo
prochains	prochain
voil	voici
ga	gars
enfain	enfin
miennes	mienne
aurais	aurait
laquelle	lequel
cernent	furent
parl	parler
atention	attention
guelle	gueule
souvenant	souvenir
auraient	auront
tien	mien
touuute	toute
clients	client
impoooorte	importe
#ciel	ciel
bb	b
_ce	ce
qulle	quelle
moint	moins
chosse	chose
sortes	sorte
permettant	permet
impresssion	impression
autruit	autrui
vnt	vont
boooonne	bonne
seuuul	seule
sormais	desormais
gueul	gueule
aurez	ayez
etiez	seriez
penssais	pense
forts	fort
aurat	aura
tfon	font
lzs	les
cettte	cette
ql	quel
denreire	premire
ch	cher
avio	avion
photoooo	photo
leurd	leur
sra	sera
oeuil	oreille
peeu	peu
lequel	laquelle
otres	autres
chanc	chance
mweu	me
forcer	force
nbses	nombreuses
chacunes	chacun
couup	coup
luii	lui
tn	ton
aurions	ayons
persone	personne
tooi	toi
passez	pass
chacuns	chacune
euuuuh	euh
serras	serai
eue	eu
grp	groupe
tiendra	tenir
pendan	pendant
cinquante	quarante
entrouverte	ouverte
rienn	rien
alr	alors
taient	soient
regarder	regard
quipes	quipe
quels	quelles
cour	cours
pir	pire
passser	pass
choisi	choix
seuuul	seul
tropppp	trop
suos	suis
personn	personne
devait	pouvait
peix	peux
flim	film
gensqui	gens
1salle	salle
touus	tous
delrey	del
viles	vives
certaine	certaines
tabt	tant
procha	prochain
vius	vous
faiim	faim
suffisait	suffit
aient	avaient
nortre	notre
beaucouo	beaucoup
foiis	fois
avoirs	avoir
lequels	lesquelles
terres	terre
morttt	mort
m0n	mon
#gauche	gauche
histo	histoire
auriez	aurez
interieure	exterieur
#secretstory	secret
dessus	dessous
apre	apres
quson	son
monn	mon
paser	pass
fzis	fais
srai	serais
peaux	peau
parleront	parlent
sentent	sent
paff	paf
moooort	mort
papiers	papier
tiendrai	tenir
tendait	tend
possibl	possible
musiq	musique
1coup	coup
looooongtemps	longtemps
huiiii	hui
foooois	fois
reniflent	parlent
aucune	aucun
uniques	unique
contrel	contre
rentreront	seront
hien	hein
sangs	sang
#journal	journal
dbon	bon
eues	eus
tpus	tous
lettres	lettre
avvez	aviez
tps	temps
tnes	es
auquels	auxquelles
treees	tre
couraant	courant
dece	ce
jsoi	sois
qlle	quelle
vpus	vous
dhui	hui
qoui	quoi
acceptables	comparables
seront	serons
truck	truc
resterais	reste
absolulent	absolument
pourais	pourrais
avz	avez
dvos	vos
peus	peux
piiire	pire
exterieure	exterieur
tienne	tien
matiiin	matin
verres	verre
croisaient	voient
partent	part
jsq	jusque
premeir	premier
courq	cours
ctre	contre
pariel	pareil
camps	camp
booooonne	bonne
habitons	ayons
jounal	journal
accort	accord
matinet	matin
suuuuuper	super
rappport	rapport
sourrir	sourire
gend	gens
rouges	rouge
minu	minute
foois	fois
cettre	cette
chaques	chaque
commznt	comment
avex	avec
apart	part
restera	reste
ouvertes	ouverts
cituation	situation
auxun	aucuns
dnotr	ntre
srait	serait
parler	parle
drte	droite
#arme	arme
parlait	parle
entrin	train
tume	me
comprie	compris
pfffff	pff
aucuns	aucune
forces	force
terr	terre
excatement	exactement
jetant	tenant
serais	serai
eu	eue
plaiz	plaisir
mienne	miennes
signait	signe
notr	ntre
messieur	monsieur
#blanc	blanc
sienne	mienne
dessu	dessus
semblera	semble
chcun	chacun
acoord	accord
lapres	apres
seraient	soient
regardais	regard
soiir	soir
semai	semaine
rester	restant
2la	la
faiite	fte
queje	que
exactemen	exactement
cliente	client
maintena	maintenant
memr	meme
merdeee	merde
1question	question
peuuuuur	peur
lesquelle	laquelle
sort	sorte
gauc	gauche
partc	part
rendrait	rend
foort	fort
mtenir	tenir
jusq	jusqu
avez	aurez
gentille	gentil
lomgtemps	longtemps
biiien	bien
orais	aurais
jtav	ta
pquoi	pourquoi
couleure	couleur
toii	toi
zentil	gentil
paaart	part
serai	seras
serras	sera
soleill	soleil
javais	avais
deoit	droit
jusuq	jusqu
pfpf	pff
revoilou	revoil
qel	quel
ton	son
punaise	putain
autes	autres
chq	chaque
enfiiin	enfin
ceux	celui
dchz	chez
chaq	chaque
chienne	chien
notr	notre
ferons	feront
longue	long
quarante	quatorze
hitoire	histoire
jaurai	aurai
certains	certain
tst	tes
bonnnne	bonne
drot	droit
miens	mienne
heurr	heure
quatres	quatre
optimale	maximale
sentiments	sentiment
images	image
hummm	hum
histoir	histoire
navons	aurions
arbe	arbre
merdeeee	merde
toujous	toujours
pence	pense
chois	choix
soient	taient
derrier	derriere
suffis	suffit
ettre	etre
bby	bb
goss	gosse
doctor	docteur
tems	temps
soooooir	soir
mauvaises	mauvais
chasue	chaque
duquel	desquelles
sut	sur
#prison	prison
nuuuuit	nuit
mmon	mon
polici	police
poru	pour
dtrou	trou
deha	deja
historie	histoire
ceuux	ceux
devront	devra
seras	sera
pourai	pourrais
longtime	longtemps
pendans	pendant
aileurs	ailleurs
couuuuurs	cours
djambe	jambe
couuurs	cours
fennetre	fentre
soiis	sois
biiiien	bien
tiut	tout
les	ls
pqu	qu
combient	combien
cte	cette
minimale	maximale
sallle	sale
touse	tous
siens	miens
deuw	deux
sera	serait
pauve	pauvre
films	film
auourd	aujourd
ttu	tu
chevaux	cheval
chake	chaque
soleillll	soleil
cheveux	cheveu
sortent	sorte
trucs	truc
souuuus	sous
serriez	serez
dssous	dessous
selaine	semaine
alllooo	allo
suffisent	suffisant
doutait	doute
pure	pur
cobtre	contre
zete	etes
exmple	exemple
solei	soleil
ravoir	avoir
laquelle	lesquelles
inporte	importe
vifs	vif
dites	dite
aurra	aura
taient	tait
tousvoici	voici
peuven	peuvent
lesquels	laquelle
blnc	blanc
ellee	elle
peuux	peux
tait	taient
merciiii	merci
povre	pauvre
dedant	dedans
tranquil	tranquille
fnd	fond
beh	bah
mme	madame
couuurs	cour
haa	ha
regardent	regard
tiennes	miens
seuleeee	seule
avzc	avec
allors	alors
aurrais	aurais
sourie	sourire
#cetteenvie	envie
lmien	mien
tendaient	tend
patronne	patron
_t	t
quau	au
droi	droit
jje	je
mariages	mariage
tllmt	tellement
hez	chez
soirei	soire
restan	restant
direeeeect	directe
mintenan	maint
parlent	parle
lpassage	passage
dsns	dans
doights	doigt
resterons	restent
enfinnn	enfin
feraient	feront
vzs	vas
dejas	deja
matinn	matin
nuul	nul
sentis	sens
pauv	pauvre
impresson	impression
flle	fille
dedand	dedans
traiin	train
mond	monde
dmes	mes
chaaud	chaud
aiie	aie
sgros	gros
soleiiiil	soleil
usqu	jusqu
nuite	nuit
souvents	souvent
auquelles	lesquelles
suive	suit
oas	pas
cafe	caf
flics	flic
dernierre	derniere
ses	tes
pui	puis
batais	bat
ooh	oh
paq	pas
dsale	sale
plaisirs	plaisir
dsu	dessus
chveu	cheveu
dzja	deja
chauuud	chaud
boi	bois
permier	premier
sentira	sent
aaie	aie
vents	vent
matiin	matin
ppar	par
ailleur	ailleurs
#anne	anne
chemins	chemin
garder	garde
bateaux	bateau
sooir	soire
navons	avons
suffisent	suffit
aujord	aujourd
jelui	lui
malgre	malgr
aurrais	avais
supers	super
possesif	possessif
langues	langue
ouvert	ouverts
ldebu	dbut
aujour	aujourd
3minutes	minute
plusieur	plusieurs
vaiis	vais
besoins	besoin
serrait	serai
#ville	ville
pourrai	pourrais
passait	pass
peeeur	peur
voial	voil
cielet	ciel
situtation	situation
ressentiment	sentiment
peuv	peuvent
quuoi	quoi
rare	rares
gpe	groupe
mienne	tienne
miens	tiennes
bonjouur	bonjour
rends	rend
meeerde	merde
accouurd	abord
auccune	aucune
ses	mes
pleeein	plein
services	service
dcet	cet
contante	content
diffrent	different
riennnn	rien
combiens	combien
loong	long
aute	autre
ecol	cole
chnace	chance
marchait	marche
mfaite	faites
truk	truc
merdeeeee	merde
cocarde	carte
parlents	parlent
dents	dent
telles	tels
noys	nous
situatio	situation
coprs	corps
bocoup	beaucoup
blaaanc	blanc
alle	all
impooorte	importe
taurais	aurais
leurd	leurs
possesif	possessifs
ttes	tte
auquels	lesquels
viif	vif
mxrde	merde
cmme	comme
seulemt	seulement
miennes	siens
aujorud	aujourd
mien	miens
esprits	esprit
2ce	ce
rende	rend
mn	mon
ctte	cette
chos	chose
oou	ou
susi	suis
entraint	train
retatd	partant
touts	tous
navez	ayez
aumoins	moins
jsoit	sois
aps	pas
toiii	toi
comtpe	compte
miennes	tiennes
retouur	retour
parol	parole
beaaau	beau
ume	une
feat	ft
2nos	nos
souvient	souvenir
apl	appel
touuus	tous
#plan	plan
cuisini	cuisine
faot	fait
sentais	sens
aller	all
parlez	parler
apel	appel
facee	face
noiveau	nouveau
graave	grave
nombreu	nombreux
#naturel	naturel
aucun	aucuns
aurait	auriez
seeul	seul
classr	classe
moind	moins
airai	aurai
chichaaaa	chiche
aah	ah
rendent	rend
gentill	gentil
#merci	merci
bravos	bravo
touuuuuus	tous
attendus	attendu
qyi	qui
eees	es
pouvoire	pouvoir
sectet	secret
1seul	seul
desquelles	duquel
sentons	serions
derneire	premire
notament	notamment
formeee	forme
aucunes	aucuns
rester	reste
ellz	elle
penses	pense
loeil	oeil
tentes	tente
bezoin	besoin
poir	pour
kartier	quartier
oaui	ouias
gosses	gosse
houste	ouste
minutes	minute
heurs	heure
juqu	jusque
semaines	semaine
hopp	hop
parlez	parle
qques	quelques
ayons	avons
bravoooo	bravo
vec	avec
miien	mien
beaux	beau
retoure	retour
foos	fois
reparler	parler
joir	jour
lesquelles	lequel
tlmt	tellement
mzs	mes
enver	envers
imposible	impossible
tmp	temps
conpte	compte
meeeeeerde	merde
signerait	signe
incomparable	comparable
oeuil	oeil
ordeur	odeur
lequels	lesquels
paner	pan
saiit	sait
qles	ls
geuele	gueule
sortir	sorte
chiot	chat
dqns	dans
seuule	seule
partants	partant
clsse	classe
cii	ci
celle	cel
revois	revoir
aaah	ah
vas	va
certaines	certaine
soi	sois
surle	sur
garderai	garde
unpeu	peu
quta	ta
eest	est
sra	seras
nouvx	nouveaux
droites	droite
#mariage	mariage
voudrait	devrait
mooooi	moi
exemples	exemple
gas	gars
septante	soixante
2notre	notre
cettz	cette
resterai	reste
trous	trou
porterai	porte
esst	est
apre	aprs
mierda	merde
soiyez	soyez
deouis	depuis
parles	parle
tces	ces
odeurs	odeur
etai	tait
dabord	abord
eues	eue
sourir	sourire
jusqu	jusque
aprs	apres
devenant	etant
plu	plus
aiiiie	aie
etais	tait
rieeeeeen	rien
different	differents
etree	tre
pauvree	pauvre
famillle	famille
copin	copain
mes	ses
dentre	entre
pluspart	plupart
contres	contre
chutt	chut
2millions	million
semblaient	semblent
couran	courant
slmnt	seulement
dejaa	deja
prler	parler
miene	mienne
fenettre	fentre
#au	au
qqui	qui
tit	petit
avion	avions
rest	reste
lzs	ls
_mes	mes
compriis	compris
aient	ait
argents	argent
faiiim	faim
sieur	monsieur
puu	pu
prsns	personnes
votre	notre
iels	ils
euuh	euh
cette	cet
heuure	heure
vuuu	vu
quelquonque	quelconque
grpe	groupe
contant	content
villes	ville
semblaient	seraient
soeuur	soeur
ldroi	droit
tends	tend
auriez	auraient
rendrais	rendre
uune	une
pis	puis
tendra	tend
fassent	faisant
porterait	porte
apr	apres
lequel	lesquelles
qelqe	quelque
maatin	matin
doooonc	donc
tels	telles
restions	tions
quartiers	quartier
pareilles	telles
1minute	minute
2se	se
rest	restant
huuui	hui
cose	cause
battai	bat
serions	serons
durant	pendant
qelque	quelque
tables	table
aspirons	aurions
oeut	peut
doigts	doigt
toooi	toi
naura	aura
moments	moment
tabl	table
trains	avions
ell	elle
aurions	aurons
possessive	possessif
marie	mari
boom	boum
branlee	balle
pani	ni
lseul	seul
aucunes	aucun
quell	quelle
tardivement	tardive
selui	celui
aucn	aucun
qqes	quelques
moin	moins
aprei	aprs
strictemen	strictement
#stop	stop
chaqun	chacun
mzrde	merde
ton	mon
cel	celle
aavais	avais
choisir	choix
aider	aide
truq	truc
restent	reste
suid	suis
darbre	arbre
ait	aurait
auquelles	auxquelles
ventuelle	telle
ayiez	aviez
classse	classe
tenterais	tente
papaaaaaa	papa
dejat	deja
lequelles	lesquelles
jboit	bois
essais	essai
biien	bien
noud	nous
guerres	guerre
habittude	habitude
aurras	aura
huii	hui
mainteant	maintenant
combie	combien
foooorme	forme
etais	tais
lesquel	laquelle
oooh	oh
lesgens	gens
lheure	heure
jusqua	jusqu
aucuns	aucun
tand	tant
tes	ses
surper	super
tocqui	toc
morte	mort
avait	aurait
soit	sois
seul	seule
voyent	voient
seront	sont
touuuuutes	toutes
famill	famille
hopla	hop
pitite	petit
maintenan	maintenant
voiiix	voix
mien	tien
leurs	leur
soooir	soire
oreil	oeil
desquels	duquel
jusuq	jusque
fauux	faux
chambree	chambre
portent	porte
soooir	soir
tardives	tardive
grs	gros
doivent	doit
arge	argent
naturels	naturelle
euuuh	euh
marchent	marche
direct	directe
#eglise	glise
serrai	serait
quevous	vous
otre	autre
#cemoment	moment
laquel	lequel
parlais	parle
ntre	vtre
pzux	peux
depui	depuis
perssone	personne
auquels	auquel
uais	ouias
lequels	lequel
ljour	jour
aurrait	aurait
teeeemps	temps
appels	appel
leur	leurs
mmoins	moins
loooooong	long
dinc	donc
villages	village
frois	froid
aurais	auraient
ohhh	oh
#pierre_cardin	pierre
queelle	quelle
avont	avons
voq	vos
reson	raison
lrs	ls
rgard	regard
pluuuuus	plus
foooond	fond
pers	personnes
permettrait	permet
#ol	ol
aurait	serait
iez	tiez
contentes	content
enfinnnn	enfin
momment	moment
devrai	devrait
cetre	cette
1en	en
pendant	durant
vlasse	classe
1mot	mot
enn	en
leus	leur
beaaaau	beau
etaid	tais
saluuut	salut
remtre	mtre
1peu	peu
qlque	quelque
endossent	eussent
vtr	votre
differents	different
desprit	esprit
heiin	hein
memme	meme
oauis	ouias
rend	rendre
avons	aurons
mmnt	moment
momant	moment
tien	tienne
uniquement	seulement
pzs	pas
abitude	habitude
voila	voil
ayiez	ayez
eue	eut
graaaaave	grave
deds	dedans
quooooi	quoi
heuuure	heure
chaqu	chacune
doight	doigt
persnne	personne
deri	derriere
chmbr	chambre
sou	sous
chacune	chacun
terrre	terre
vouuuuus	vous
seuuule	seule
tres	trs
entrain	train
lesquels	lequel
devrait	devra
resteraient	restent
bne	bonne
rares	rare
situa	situation
ns	nous
garderont	feront
parlerait	parle
soleille	soleil
prsn	personne
vingts	vingt
bsn	besoin
soiree	soire
journ	journe
saaal	sale
malgree	malgr
oeu	peu
certain	certaine
jaurai	aurais
forcent	force
fassiez	faites
marcher	marche
seux	ceux
cmmt	comment
famillee	famille
1verre	verre
parfoit	parfois
elleux	eux
tenter	tente
uje	une
geurre	guerre
fami	famille
faaais	fais
nonnnn	non
apas	as
moois	mois
vieuux	vieux
aides	aide
ect	etc
rendrai	rend
maitenant	maintenant
envi	envie
voit	voient
dans	ds
npus	nous
suiite	suite
lmeilleur	meilleur
etr	tre
bonsoir	bonjour
#film	film
restaient	restent
quelque	quelques
journaux	journal
dzns	ds
serait	serais
fonnnnd	fond
partis	partie
mavoir	avoir
juqu	jusqu
pount	point
aspirons	avons
peuu	peu
beacoup	beaucoup
huum	hum
parceque	parce
tooute	tte
chause	chose
epoque	poque
bizzarre	bizarre
feunetre	fentre
spnt	sont
defois	parfois
seront	soient
desquels	desquelles
allrs	alors
devraient	doivent
secrets	secret
direeect	directe
milions	million
jusq	jusque
prsnne	prs
bleue	bleu
dsoleil	soleil
cz	chez
sois	soi
beaucoups	beaucoup
vides	vide
appellent	appel
dehor	dehors
lcoup	coup
font	feront
1iere	derniere
vois	voie
fleure	fleur
risquerez	seriez
besion	besoin
euhhhh	euh
copines	copain
apred	apres
ac	avec
cotre	contre
ouvert	ouverte
ts	tous
merciii	merci
vons	vont
milles	mille
fessant	faisant
pareik	pareil
vaus	vas
touuuuus	tous
lesquelles	lesquels
pouvai	pouvait
meiilleur	meilleur
bhe	bah
leut	leur
aprzs	apres
sensation	sentiment
troop	trop
questions	question
maos	mais
lequel	lesquels
touuuuut	tout
gueulle	gueule
chichaaa	chiche
mainet	main
allooooo	allo
chauque	chaque
foutrement	strictement
tr	tres
aec	avec
putainnnnn	putain
moooonde	monde
heuree	heure
bcoup	beaucoup
oust	ouste
ouah	pouah
quatre	quatorze
toues	toutes
avoit	avoir
euxils	eux
espris	esprit
sujets	sujet
hodeur	odeur
bizzare	bizarre
duquel	desquels
possesive	possessif
#bois	bois
#teamle	egale
tentent	tente
chaton	chat
soiiiiir	soir
quatorze	quarante
prochai	prochain
chacuns	chacun
suffisais	suffit
regarde	regard
sal	sale
retente	tente
classes	classe
lgtmps	longtemps
essaiera	essai
mfaites	faites
derni	derniere
hmm	hum
comprid	compris
hotell	htel
tt	tout
enretard	retard
possessifs	possessif
diff	different
luuuui	lui
clik	clic
aupr	aupres
rende	rendre
relatifs	relative
besoinde	besoin
peuuu	peu
sien	mien
graaaave	grave
nuiiiit	nuit
etait	tais
trin	train
noon	non
voies	voie
#beforesecret	secret
xhez	chez
pur	pure
raisoooon	raison
troiscinquantetrois	cinquante
ayons	aurons
viff	vif
repartant	partant
encour	cour
serions	soyons
serons	serions
faos	fais
marige	mariage
hisoire	histoire
poins	point
ube	une
oes	les
touuuutes	toutes
alrs	alors
#terre	terre
plsu	plus
eue	eus
mienne	miens
kvos	vos
nbreuses	nombreuses
apret	apres
veront	voient
mouvements	mouvement
atypiques	uniques
aut	autre
exple	exemple
ettes	etes
tzs	tes
commnt	comment
vuu	vu
touts	toutes
pourrait	pouvait
groooos	gros
retaaard	retard
impoorte	importe
types	type
suffirai	suffit
retourd	retour
importes	importe
jdise	dire
aurai	aurait
probables	probable
pouvoirs	pouvoir
troo	trop
importantes	important
serrez	seriez
fais	fait
drois	droit
celon	selon
aurait	ait
#carte	carte
iil	il
passe	pass
vaiq	vais
tranquillou	tranquille
direeeee	dire
ppour	pour
chancun	chacun
lmetre	mtre
raport	rapport
votr	vtre
taant	tant
bieeen	bien
ormais	desormais
tenterait	tente
voulait	pouvait
plaisiiiir	plaisir
jusk	jusqu
toinous	nous
serait	sera
#droite	droite
entiere	entier
malde	malade
entrai	train
recoin	coin
seraient	taient
poches	poche
cellui	celle
bureaux	bureau
riena	rien
chere	chers
armure	arme
snas	sans
aavait	ait
quarante	cinquante
restiez	tiez
celleux	ceux
ells	elles
bruits	bruit
404erreur	erreur
bnne	bonne
alord	alors
accore	accord
bonjours	bonjour
goche	gauche
exactment	exactement
chmbre	chambre
pzr	par
touuuuute	toute
votre	vtre
moiii	moi
chaqu	chacun
meilleurs	meilleur
auccun	aucuns
balles	balle
bienn	bien
regar	regard
serrons	serions
cez	chez
sront	seront
longtemp	longtemps
vaais	vais
cett	cet
celly	cel
faiiiim	faim
ppas	pas
groooooos	gros
certains	certaines
traversant	travers
avit	avait
ehhh	eh
tien	tiens
moiiii	moi
eu	eus
navires	avions
servic	service
ontpas	ont
dedns	dedans
ventr	ventre
chanceee	chance
lees	ls
lsigne	signe
gossss	gosse
vait	vais
fonnd	fond
doutais	doute
etan	etant
entrains	train
grooos	gros
serait	seraient
comrpis	compris
audacieuses	diverses
biiiiien	bien
rvous	vous
soixantaine	cinquantaine
aivais	avais
meeme	meme
einh	hein
certaines	certains
puiis	puis
detre	etre
aui	qui
tait	tais
puissent	peuvent
parents	parent
cents	cent
peuuuu	peu
estait	tait
eus	eut
exempl	exemple
courrant	courant
faimmmm	faim
tranquile	tranquille
millards	mille
vue	vu
ellr	elle
persones	personnes
tte	toute
etait	tait
2mois	mois
soient	seront
#soleil	soleil
tllm	tellement
pret	pres
mooot	mot
ehh	eh
#police	police
miens	siens
chooooose	chose
photoo	photo
personns	personnes
faaaaim	faim
piec	pice
semaiine	semaine
biennnn	bien
emouvant	touchant
serras	serais
entres	entre
toc_qui	toc
aites	etes
oeils	oeil
equipe	quipe
1million	million
qma	ma
musiques	musique
desous	dessous
suiiiite	suite
ddu	du
dvotre	votre
mooonde	monde
resteront	restent
dvais	vas
aurons	avons
seulle	seul
srai	serait
gouvernemt	gouvernement
saluut	salut
#cesgens	celles
marcherons	serons
suivait	suit
comprit	compris
vieu	vieux
quand	quant
acune	aucune
peines	peine
porter	porte
supert	super
#aide	aide
passee	pass
bouuuum	boum
pourvoir	pouvoir
vut	vu
cheres	chers
komme	comme
aucun	aucune
chuuuut	chut
lla	la
oreilles	oreille
soleeeeeil	soleil
dns	dans
amouuuur	amour
foto	photo
veers	vers
plupar	plupart
ahhh	ah
tiendrais	tiens
referont	feront
froiiiiid	froid
radeau	bateau
alll	all
deriere	derriere
peti	petit
aujourdh	aujourd
dautrui	autrui
#froid	froid
hooop	hop
clientele	client
unn	un
booon	bon
allz	all
rapporr	rapport
deniere	derniere
histoires	histoire
allions	allons
journei	journe
jusqa	jusque
grooooos	gros
caboche	poche
courss	cours
treize	trente
gosss	gosse
booonne	bonne
saa	sa
trooop	trop
exemp	exemple
maintenent	maintenant
smaine	semaine
acause	cause
sont	seront
tiennes	tien
verte	vert
jouur	jour
urent	eurent
quelel	quelle
dprison	prison
questio	question
